Ano;Semestre;CNPJ AC;Administradora de consórcio;Irregularidade;Quantidade de reclamações reguladas procedentes;Quantidade de reclamações reguladas - outras;Quantidade de reclamações não reguladas;Quantidade total de reclamações;
2020;1º;91984633;ACERTE ADMINISTRADORA DE CONSÓRCIOS LTDA.;Descumprimento de obrigações previstas em contratos;1;0;0;1;
2020;1º;91984633;ACERTE ADMINISTRADORA DE CONSÓRCIOS LTDA.;Descumprimento de prazo de resposta a demanda;1;0;0;1;
2020;1º;91984633;ACERTE ADMINISTRADORA DE CONSÓRCIOS LTDA.;Outras irregularidades;3;4;0;7;
2020;1º;91984633;ACERTE ADMINISTRADORA DE CONSÓRCIOS LTDA.;Publicidade enganosa;0;0;1;1;
2020;1º;84911098;ADEMILAR ADMINISTRADORA DE CONSORCIOS S.A.;Descumprimento de cláusulas referentes à devolução de valores;0;1;0;1;
2020;1º;84911098;ADEMILAR ADMINISTRADORA DE CONSORCIOS S.A.;Descumprimento de obrigações previstas em contratos;0;2;0;2;
2020;1º;84911098;ADEMILAR ADMINISTRADORA DE CONSORCIOS S.A.;Insatisfação com a resposta fornecida pela administradora de consórcio relativa à demanda registrada contra ela;0;1;0;1;
2020;1º;84911098;ADEMILAR ADMINISTRADORA DE CONSORCIOS S.A.;Reclamações relacionadas a assuntos diversos;0;0;1;1;
2020;1º;84911098;ADEMILAR ADMINISTRADORA DE CONSORCIOS S.A.;Recusa ou demora no fornecimento de documentos (exceto demonstrativos obrigatórios);0;0;1;1;
2020;1º;06044551;ADMINISTRADORA DE CONSORCIO NACIONAL GAZIN LTDA;Recusa ou demora no fornecimento de documentos (exceto demonstrativos obrigatórios);0;0;1;1;
2020;1º;45441789;ADMINISTRADORA DE CONSORCIO NACIONAL HONDA LTDA;Descumprimento de cláusulas referentes à devolução de valores;5;5;0;10;
2020;1º;45441789;ADMINISTRADORA DE CONSORCIO NACIONAL HONDA LTDA;Descumprimento de obrigações previstas em contratos;3;6;0;9;
2020;1º;45441789;ADMINISTRADORA DE CONSORCIO NACIONAL HONDA LTDA;Descumprimento de prazo de resposta a demanda;0;1;0;1;
2020;1º;45441789;ADMINISTRADORA DE CONSORCIO NACIONAL HONDA LTDA;Dificuldade na liberação ou substituição de bem;0;0;2;2;
2020;1º;45441789;ADMINISTRADORA DE CONSORCIO NACIONAL HONDA LTDA;Insatisfação com a resposta fornecida pela administradora de consórcio relativa à demanda registrada contra ela;0;3;0;3;
2020;1º;45441789;ADMINISTRADORA DE CONSORCIO NACIONAL HONDA LTDA;Insatisfação por parte do cliente com o atendimento prestado pela administradora de consórcio;0;0;4;4;
2020;1º;45441789;ADMINISTRADORA DE CONSORCIO NACIONAL HONDA LTDA;Irregularidades relacionadas à liberação do crédito;7;29;0;36;
2020;1º;45441789;ADMINISTRADORA DE CONSORCIO NACIONAL HONDA LTDA;Irregularidades relacionadas às condições para contemplação por lance ou sorteio;0;4;0;4;
2020;1º;45441789;ADMINISTRADORA DE CONSORCIO NACIONAL HONDA LTDA;Não fornecimento, remessa ou divulgação de documentos obrigatórios;2;0;0;2;
2020;1º;45441789;ADMINISTRADORA DE CONSORCIO NACIONAL HONDA LTDA;Outras irregularidades;1;4;0;5;
2020;1º;45441789;ADMINISTRADORA DE CONSORCIO NACIONAL HONDA LTDA;Prestação inadequada/insuficiente de informação;0;0;2;2;
2020;1º;45441789;ADMINISTRADORA DE CONSORCIO NACIONAL HONDA LTDA;Reclamações relacionadas a assuntos diversos;0;0;18;18;
2020;1º;45441789;ADMINISTRADORA DE CONSORCIO NACIONAL HONDA LTDA;Recusa ou demora no fornecimento de documentos (exceto demonstrativos obrigatórios);0;0;2;2;
2020;1º;07808907;ADMINISTRADORA DE CONSORCIOS SICREDI LTDA;Reclamações relacionadas a assuntos diversos;0;0;1;1;
2020;1º;30412977;ADMINISTRADORA DE CONSÓRCIO NACIONAL LÍDER LTDA.;Reclamações relacionadas a assuntos diversos;0;0;1;1;
2020;1º;03765340;ADMINISTRADORA DE CONSÓRCIO NACIONAL VALOR LTDA.;Descumprimento de obrigações previstas em contratos;1;0;0;1;
2020;1º;03765340;ADMINISTRADORA DE CONSÓRCIO NACIONAL VALOR LTDA.;Descumprimento de prazo de resposta a demanda;2;0;0;2;
2020;1º;03765340;ADMINISTRADORA DE CONSÓRCIO NACIONAL VALOR LTDA.;Insatisfação com a resposta fornecida pela administradora de consórcio relativa à demanda registrada contra ela;2;1;0;3;
2020;1º;03765340;ADMINISTRADORA DE CONSÓRCIO NACIONAL VALOR LTDA.;Insatisfação por parte do cliente com o atendimento prestado pela administradora de consórcio;0;0;1;1;
2020;1º;03765340;ADMINISTRADORA DE CONSÓRCIO NACIONAL VALOR LTDA.;Irregularidades relacionadas às condições para contemplação por lance ou sorteio;1;1;0;2;
2020;1º;03765340;ADMINISTRADORA DE CONSÓRCIO NACIONAL VALOR LTDA.;Outras irregularidades;3;8;0;11;
2020;1º;03765340;ADMINISTRADORA DE CONSÓRCIO NACIONAL VALOR LTDA.;Outras irregularidades relacionadas à Ouvidoria;1;0;0;1;
2020;1º;03765340;ADMINISTRADORA DE CONSÓRCIO NACIONAL VALOR LTDA.;Prestação inadequada/insuficiente de informação;0;0;1;1;
2020;1º;03765340;ADMINISTRADORA DE CONSÓRCIO NACIONAL VALOR LTDA.;Publicidade enganosa;0;0;3;3;
2020;1º;73230674;ADMINISTRADORA DE CONSÓRCIO RCI BRASIL LTDA;Ausência de transparência nas relações contratuais;0;0;1;1;
2020;1º;73230674;ADMINISTRADORA DE CONSÓRCIO RCI BRASIL LTDA;Descumprimento de obrigações previstas em contratos;0;1;0;1;
2020;1º;73230674;ADMINISTRADORA DE CONSÓRCIO RCI BRASIL LTDA;Insatisfação por parte do cliente com o atendimento prestado pela administradora de consórcio;0;0;2;2;
2020;1º;73230674;ADMINISTRADORA DE CONSÓRCIO RCI BRASIL LTDA;Irregularidades relacionadas à liberação do crédito;0;3;0;3;
2020;1º;73230674;ADMINISTRADORA DE CONSÓRCIO RCI BRASIL LTDA;Irregularidades relacionadas às condições para contemplação por lance ou sorteio;0;1;0;1;
2020;1º;73230674;ADMINISTRADORA DE CONSÓRCIO RCI BRASIL LTDA;Prestação inadequada/insuficiente de informação;0;0;1;1;
2020;1º;73230674;ADMINISTRADORA DE CONSÓRCIO RCI BRASIL LTDA;Reclamações relacionadas a assuntos diversos;0;0;1;1;
2020;1º;73230674;ADMINISTRADORA DE CONSÓRCIO RCI BRASIL LTDA;Recusa ou demora no fornecimento de documentos (exceto demonstrativos obrigatórios);0;0;1;1;
2020;1º;94187879;AGIBANK ADMINISTRADORA DE CONSÓRCIOS LTDA;Descumprimento de cláusulas referentes à devolução de valores;1;0;0;1;
2020;1º;94187879;AGIBANK ADMINISTRADORA DE CONSÓRCIOS LTDA;Descumprimento de obrigações previstas em contratos;1;0;0;1;
2020;1º;94187879;AGIBANK ADMINISTRADORA DE CONSÓRCIOS LTDA;Outras irregularidades;0;1;0;1;
2020;1º;60375243;ANCORA ADMINISTRADORA DE CONSORCIOS S.A.;Ausência de transparência nas relações contratuais;0;0;1;1;
2020;1º;60375243;ANCORA ADMINISTRADORA DE CONSORCIOS S.A.;Descumprimento de cláusulas referentes à devolução de valores;0;1;0;1;
2020;1º;60375243;ANCORA ADMINISTRADORA DE CONSORCIOS S.A.;Irregularidades relacionadas às condições para contemplação por lance ou sorteio;0;1;0;1;
2020;1º;60375243;ANCORA ADMINISTRADORA DE CONSORCIOS S.A.;Outras irregularidades;1;0;0;1;
2020;1º;60375243;ANCORA ADMINISTRADORA DE CONSORCIOS S.A.;Prestação inadequada/insuficiente de informação;0;0;1;1;
2020;1º;71045363;BAMAQ ADMINISTRADORA DE CONSÓRCIOS LTDA;Descumprimento de obrigações previstas em contratos;0;1;0;1;
2020;1º;71045363;BAMAQ ADMINISTRADORA DE CONSÓRCIOS LTDA;Irregularidades relacionadas à liberação do crédito;0;1;0;1;
2020;1º;71045363;BAMAQ ADMINISTRADORA DE CONSÓRCIOS LTDA;Irregularidades relacionadas às condições para contemplação por lance ou sorteio;0;1;0;1;
2020;1º;71045363;BAMAQ ADMINISTRADORA DE CONSÓRCIOS LTDA;Outras irregularidades;1;0;0;1;
2020;1º;71045363;BAMAQ ADMINISTRADORA DE CONSÓRCIOS LTDA;Reclamações relacionadas a assuntos diversos;0;0;1;1;
2020;1º;02010478;BANCORBRÁS ADMINISTRADORA DE CONSÓRCIOS S.A.;Descumprimento de cláusulas referentes à devolução de valores;1;4;0;5;
2020;1º;02010478;BANCORBRÁS ADMINISTRADORA DE CONSÓRCIOS S.A.;Descumprimento de obrigações previstas em contratos;2;0;0;2;
2020;1º;02010478;BANCORBRÁS ADMINISTRADORA DE CONSÓRCIOS S.A.;Insatisfação com a resposta fornecida pela administradora de consórcio relativa à demanda registrada contra ela;0;1;0;1;
2020;1º;02010478;BANCORBRÁS ADMINISTRADORA DE CONSÓRCIOS S.A.;Insatisfação por parte do cliente com o atendimento prestado pela administradora de consórcio;0;0;1;1;
2020;1º;02010478;BANCORBRÁS ADMINISTRADORA DE CONSÓRCIOS S.A.;Irregularidades relacionadas à liberação do crédito;0;1;0;1;
2020;1º;02010478;BANCORBRÁS ADMINISTRADORA DE CONSÓRCIOS S.A.;Irregularidades relacionadas às condições para contemplação por lance ou sorteio;0;1;0;1;
2020;1º;02010478;BANCORBRÁS ADMINISTRADORA DE CONSÓRCIOS S.A.;Não fornecimento, remessa ou divulgação de documentos obrigatórios;1;0;0;1;
2020;1º;02010478;BANCORBRÁS ADMINISTRADORA DE CONSÓRCIOS S.A.;Outras irregularidades;0;2;0;2;
2020;1º;02010478;BANCORBRÁS ADMINISTRADORA DE CONSÓRCIOS S.A.;Prestação inadequada/insuficiente de informação;0;0;1;1;
2020;1º;02010478;BANCORBRÁS ADMINISTRADORA DE CONSÓRCIOS S.A.;Recusa ou demora no fornecimento de documentos (exceto demonstrativos obrigatórios);0;0;1;1;
2020;1º;92692979;BANRISUL S.A. - ADMINISTRADORA DE CONSÓRCIOS;Descumprimento de obrigações previstas em contratos;0;1;0;1;
2020;1º;92692979;BANRISUL S.A. - ADMINISTRADORA DE CONSÓRCIOS;Dificuldade na liberação ou substituição de bem;0;0;1;1;
2020;1º;92692979;BANRISUL S.A. - ADMINISTRADORA DE CONSÓRCIOS;Insatisfação por parte do cliente com o atendimento prestado pela administradora de consórcio;0;0;1;1;
2020;1º;92692979;BANRISUL S.A. - ADMINISTRADORA DE CONSÓRCIOS;Irregularidades relacionadas à liberação do crédito;0;2;0;2;
2020;1º;92692979;BANRISUL S.A. - ADMINISTRADORA DE CONSÓRCIOS;Reclamações relacionadas a assuntos diversos;0;0;1;1;
2020;1º;92692979;BANRISUL S.A. - ADMINISTRADORA DE CONSÓRCIOS;Recusa ou demora no fornecimento de documentos (exceto demonstrativos obrigatórios);0;0;2;2;
2020;1º;06043050;BB ADMINISTRADORA DE CONSORCIOS S.A.;Ausência de informações/cláusulas obrigatórias em contrato;1;0;0;1;
2020;1º;06043050;BB ADMINISTRADORA DE CONSORCIOS S.A.;Ausência de transparência nas relações contratuais;0;0;1;1;
2020;1º;06043050;BB ADMINISTRADORA DE CONSORCIOS S.A.;Descumprimento de cláusulas referentes à devolução de valores;2;16;0;18;
2020;1º;06043050;BB ADMINISTRADORA DE CONSORCIOS S.A.;Descumprimento de obrigações previstas em contratos;5;13;0;18;
2020;1º;06043050;BB ADMINISTRADORA DE CONSORCIOS S.A.;Dificuldade na liberação ou substituição de bem;0;0;5;5;
2020;1º;06043050;BB ADMINISTRADORA DE CONSORCIOS S.A.;Insatisfação com a resposta fornecida pela administradora de consórcio relativa à demanda registrada contra ela;2;1;0;3;
2020;1º;06043050;BB ADMINISTRADORA DE CONSORCIOS S.A.;Insatisfação por parte do cliente com o atendimento prestado pela administradora de consórcio;0;0;4;4;
2020;1º;06043050;BB ADMINISTRADORA DE CONSORCIOS S.A.;Irregularidades relacionadas à liberação do crédito;4;18;0;22;
2020;1º;06043050;BB ADMINISTRADORA DE CONSORCIOS S.A.;Irregularidades relacionadas às condições para contemplação por lance ou sorteio;1;1;0;2;
2020;1º;06043050;BB ADMINISTRADORA DE CONSORCIOS S.A.;Não fornecimento, remessa ou divulgação de documentos obrigatórios;0;2;0;2;
2020;1º;06043050;BB ADMINISTRADORA DE CONSORCIOS S.A.;Outras irregularidades;1;4;0;5;
2020;1º;06043050;BB ADMINISTRADORA DE CONSORCIOS S.A.;Prestação inadequada/insuficiente de informação;0;0;6;6;
2020;1º;06043050;BB ADMINISTRADORA DE CONSORCIOS S.A.;Reclamações relacionadas a assuntos diversos;0;0;8;8;
2020;1º;06043050;BB ADMINISTRADORA DE CONSORCIOS S.A.;Recusa ou demora no fornecimento de documentos (exceto demonstrativos obrigatórios);0;0;8;8;
2020;1º;14723388;BR CONSÓRCIOS ADMINISTRADORA DE CONSÓRCIOS LTDA;Descumprimento de cláusulas referentes à devolução de valores;0;4;0;4;
2020;1º;14723388;BR CONSÓRCIOS ADMINISTRADORA DE CONSÓRCIOS LTDA;Descumprimento de obrigações previstas em contratos;0;2;0;2;
2020;1º;14723388;BR CONSÓRCIOS ADMINISTRADORA DE CONSÓRCIOS LTDA;Dificuldade na liberação ou substituição de bem;0;0;1;1;
2020;1º;14723388;BR CONSÓRCIOS ADMINISTRADORA DE CONSÓRCIOS LTDA;Insatisfação com a resposta fornecida pela administradora de consórcio relativa à demanda registrada contra ela;0;1;0;1;
2020;1º;14723388;BR CONSÓRCIOS ADMINISTRADORA DE CONSÓRCIOS LTDA;Insatisfação por parte do cliente com o atendimento prestado pela administradora de consórcio;0;0;1;1;
2020;1º;14723388;BR CONSÓRCIOS ADMINISTRADORA DE CONSÓRCIOS LTDA;Irregularidades relacionadas à liberação do crédito;0;3;0;3;
2020;1º;14723388;BR CONSÓRCIOS ADMINISTRADORA DE CONSÓRCIOS LTDA;Outras irregularidades;0;1;0;1;
2020;1º;52568821;BRADESCO ADMINISTRADORA DE CONSÓRCIOS LTDA.;Ausência de informações/cláusulas obrigatórias em contrato;0;1;0;1;
2020;1º;52568821;BRADESCO ADMINISTRADORA DE CONSÓRCIOS LTDA.;Ausência de transparência nas relações contratuais;0;0;8;8;
2020;1º;52568821;BRADESCO ADMINISTRADORA DE CONSÓRCIOS LTDA.;Cobrança irregular de tarifa pela emissão de boletos, carnês e assemelhados;0;3;0;3;
2020;1º;52568821;BRADESCO ADMINISTRADORA DE CONSÓRCIOS LTDA.;Descumprimento de cláusulas referentes à devolução de valores;3;53;0;56;
2020;1º;52568821;BRADESCO ADMINISTRADORA DE CONSÓRCIOS LTDA.;Descumprimento de obrigações previstas em contratos;8;74;0;82;
2020;1º;52568821;BRADESCO ADMINISTRADORA DE CONSÓRCIOS LTDA.;Descumprimento de prazo de resposta a demanda;2;10;0;12;
2020;1º;52568821;BRADESCO ADMINISTRADORA DE CONSÓRCIOS LTDA.;Dificuldade na liberação ou substituição de bem;0;0;39;39;
2020;1º;52568821;BRADESCO ADMINISTRADORA DE CONSÓRCIOS LTDA.;Insatisfação com a resposta fornecida pela administradora de consórcio relativa à demanda registrada contra ela;1;28;0;29;
2020;1º;52568821;BRADESCO ADMINISTRADORA DE CONSÓRCIOS LTDA.;Insatisfação por parte do cliente com o atendimento prestado pela administradora de consórcio;0;0;12;12;
2020;1º;52568821;BRADESCO ADMINISTRADORA DE CONSÓRCIOS LTDA.;Irregularidades relacionadas à liberação do crédito;2;83;0;85;
2020;1º;52568821;BRADESCO ADMINISTRADORA DE CONSÓRCIOS LTDA.;Irregularidades relacionadas às condições para contemplação por lance ou sorteio;0;7;0;7;
2020;1º;52568821;BRADESCO ADMINISTRADORA DE CONSÓRCIOS LTDA.;Não fornecimento, remessa ou divulgação de documentos obrigatórios;2;3;0;5;
2020;1º;52568821;BRADESCO ADMINISTRADORA DE CONSÓRCIOS LTDA.;Outras irregularidades;5;15;0;20;
2020;1º;52568821;BRADESCO ADMINISTRADORA DE CONSÓRCIOS LTDA.;Outras irregularidades relacionadas à Ouvidoria;0;1;0;1;
2020;1º;52568821;BRADESCO ADMINISTRADORA DE CONSÓRCIOS LTDA.;Prestação inadequada/insuficiente de informação;0;0;28;28;
2020;1º;52568821;BRADESCO ADMINISTRADORA DE CONSÓRCIOS LTDA.;Publicidade enganosa;0;0;1;1;
2020;1º;52568821;BRADESCO ADMINISTRADORA DE CONSÓRCIOS LTDA.;Reclamações relacionadas a assuntos diversos;0;0;77;77;
2020;1º;52568821;BRADESCO ADMINISTRADORA DE CONSÓRCIOS LTDA.;Recusa ou demora no fornecimento de documentos (exceto demonstrativos obrigatórios);0;0;23;23;
2020;1º;73235962;BREITKOPF ADMINISTRADORA DE CONSÓRCIO LTDA.;Descumprimento de obrigações previstas em contratos;0;1;0;1;
2020;1º;06046109;BRISA ADMINISTRADORA DE CONSORCIOS LTDA;Descumprimento de cláusulas referentes à devolução de valores;0;1;0;1;
2020;1º;05349595;CAIXA CONSÓRCIOS S.A ADMINISTRADORA DE CONSÓRCIOS;Ausência de transparência nas relações contratuais;0;0;1;1;
2020;1º;05349595;CAIXA CONSÓRCIOS S.A ADMINISTRADORA DE CONSÓRCIOS;Descumprimento de cláusulas referentes à devolução de valores;2;10;0;12;
2020;1º;05349595;CAIXA CONSÓRCIOS S.A ADMINISTRADORA DE CONSÓRCIOS;Descumprimento de obrigações previstas em contratos;8;10;0;18;
2020;1º;05349595;CAIXA CONSÓRCIOS S.A ADMINISTRADORA DE CONSÓRCIOS;Descumprimento de prazo de resposta a demanda;0;1;0;1;
2020;1º;05349595;CAIXA CONSÓRCIOS S.A ADMINISTRADORA DE CONSÓRCIOS;Insatisfação por parte do cliente com o atendimento prestado pela administradora de consórcio;0;0;6;6;
2020;1º;05349595;CAIXA CONSÓRCIOS S.A ADMINISTRADORA DE CONSÓRCIOS;Irregularidades relacionadas à liberação do crédito;6;34;0;40;
2020;1º;05349595;CAIXA CONSÓRCIOS S.A ADMINISTRADORA DE CONSÓRCIOS;Irregularidades relacionadas às condições para contemplação por lance ou sorteio;1;1;0;2;
2020;1º;05349595;CAIXA CONSÓRCIOS S.A ADMINISTRADORA DE CONSÓRCIOS;Não fornecimento, remessa ou divulgação de documentos obrigatórios;1;1;0;2;
2020;1º;05349595;CAIXA CONSÓRCIOS S.A ADMINISTRADORA DE CONSÓRCIOS;Outras irregularidades;3;7;0;10;
2020;1º;05349595;CAIXA CONSÓRCIOS S.A ADMINISTRADORA DE CONSÓRCIOS;Prestação inadequada/insuficiente de informação;0;0;9;9;
2020;1º;05349595;CAIXA CONSÓRCIOS S.A ADMINISTRADORA DE CONSÓRCIOS;Reclamações relacionadas a assuntos diversos;0;0;32;32;
2020;1º;05349595;CAIXA CONSÓRCIOS S.A ADMINISTRADORA DE CONSÓRCIOS;Recusa ou demora no fornecimento de documentos (exceto demonstrativos obrigatórios);0;0;4;4;
2020;1º;72461643;CAMVEL ADMINISTRADORA DE CONSÓRCIOS LTDA.;Irregularidades relacionadas à liberação do crédito;0;1;0;1;
2020;1º;68318773;CANOPUS ADMINISTRADORA DE CONSORCIOS S/A;Descumprimento de cláusulas referentes à devolução de valores;0;1;0;1;
2020;1º;68318773;CANOPUS ADMINISTRADORA DE CONSORCIOS S/A;Descumprimento de obrigações previstas em contratos;0;1;0;1;
2020;1º;68318773;CANOPUS ADMINISTRADORA DE CONSORCIOS S/A;Descumprimento de prazo de resposta a demanda;0;1;0;1;
2020;1º;68318773;CANOPUS ADMINISTRADORA DE CONSORCIOS S/A;Irregularidades relacionadas à liberação do crédito;0;1;0;1;
2020;1º;68318773;CANOPUS ADMINISTRADORA DE CONSORCIOS S/A;Irregularidades relacionadas às condições para contemplação por lance ou sorteio;0;1;0;1;
2020;1º;68318773;CANOPUS ADMINISTRADORA DE CONSORCIOS S/A;Outras irregularidades;4;1;0;5;
2020;1º;68318773;CANOPUS ADMINISTRADORA DE CONSORCIOS S/A;Prestação inadequada/insuficiente de informação;0;0;1;1;
2020;1º;00266031;CICAL ADMINISTRADORA DE CONSÓRCIOS LTDA;Reclamações relacionadas a assuntos diversos;0;0;1;1;
2020;1º;59129403;CNF - ADMINISTRADORA DE CONSÓRCIOS NACIONAL LTDA.;Descumprimento de cláusulas referentes à devolução de valores;0;1;0;1;
2020;1º;59129403;CNF - ADMINISTRADORA DE CONSÓRCIOS NACIONAL LTDA.;Descumprimento de obrigações previstas em contratos;0;1;0;1;
2020;1º;59129403;CNF - ADMINISTRADORA DE CONSÓRCIOS NACIONAL LTDA.;Dificuldade na liberação ou substituição de bem;0;0;1;1;
2020;1º;59129403;CNF - ADMINISTRADORA DE CONSÓRCIOS NACIONAL LTDA.;Insatisfação por parte do cliente com o atendimento prestado pela administradora de consórcio;0;0;1;1;
2020;1º;59129403;CNF - ADMINISTRADORA DE CONSÓRCIOS NACIONAL LTDA.;Irregularidades relacionadas à liberação do crédito;0;1;0;1;
2020;1º;59129403;CNF - ADMINISTRADORA DE CONSÓRCIOS NACIONAL LTDA.;Reclamações relacionadas a assuntos diversos;0;0;1;1;
2020;1º;27268770;COIMEX ADMINISTRADORA DE CONSÓRCIOS S.A.;Outras irregularidades;1;1;0;2;
2020;1º;27268770;COIMEX ADMINISTRADORA DE CONSÓRCIOS S.A.;Reclamações relacionadas a assuntos diversos;0;0;2;2;
2020;1º;81742223;CONSEG ADMINISTRADORA DE CONSÓRCIOS S/A;Insatisfação com a resposta fornecida pela administradora de consórcio relativa à demanda registrada contra ela;0;1;0;1;
2020;1º;81742223;CONSEG ADMINISTRADORA DE CONSÓRCIOS S/A;Irregularidades relacionadas à liberação do crédito;0;1;0;1;
2020;1º;81742223;CONSEG ADMINISTRADORA DE CONSÓRCIOS S/A;Prestação inadequada/insuficiente de informação;0;0;1;1;
2020;1º;44196293;CONSHOP ADMINISTRADORA DE CONSORCIOS LTDA.;Descumprimento de cláusulas referentes à devolução de valores;0;1;0;1;
2020;1º;47658539;CONSÓRCIO NACIONAL VOLKSWAGEN - ADMINISTRADORA DE CONSÓRCIO LTDA.;Descumprimento de cláusulas referentes à devolução de valores;8;18;0;26;
2020;1º;47658539;CONSÓRCIO NACIONAL VOLKSWAGEN - ADMINISTRADORA DE CONSÓRCIO LTDA.;Descumprimento de obrigações previstas em contratos;3;10;0;13;
2020;1º;47658539;CONSÓRCIO NACIONAL VOLKSWAGEN - ADMINISTRADORA DE CONSÓRCIO LTDA.;Descumprimento de prazo de resposta a demanda;2;0;0;2;
2020;1º;47658539;CONSÓRCIO NACIONAL VOLKSWAGEN - ADMINISTRADORA DE CONSÓRCIO LTDA.;Dificuldade na liberação ou substituição de bem;0;0;3;3;
2020;1º;47658539;CONSÓRCIO NACIONAL VOLKSWAGEN - ADMINISTRADORA DE CONSÓRCIO LTDA.;Insatisfação com a resposta fornecida pela administradora de consórcio relativa à demanda registrada contra ela;0;5;0;5;
2020;1º;47658539;CONSÓRCIO NACIONAL VOLKSWAGEN - ADMINISTRADORA DE CONSÓRCIO LTDA.;Insatisfação por parte do cliente com o atendimento prestado pela administradora de consórcio;0;0;3;3;
2020;1º;47658539;CONSÓRCIO NACIONAL VOLKSWAGEN - ADMINISTRADORA DE CONSÓRCIO LTDA.;Irregularidades relacionadas à liberação do crédito;8;15;0;23;
2020;1º;47658539;CONSÓRCIO NACIONAL VOLKSWAGEN - ADMINISTRADORA DE CONSÓRCIO LTDA.;Outras irregularidades;2;2;0;4;
2020;1º;47658539;CONSÓRCIO NACIONAL VOLKSWAGEN - ADMINISTRADORA DE CONSÓRCIO LTDA.;Prestação inadequada/insuficiente de informação;0;0;4;4;
2020;1º;47658539;CONSÓRCIO NACIONAL VOLKSWAGEN - ADMINISTRADORA DE CONSÓRCIO LTDA.;Reclamações relacionadas a assuntos diversos;0;0;14;14;
2020;1º;47658539;CONSÓRCIO NACIONAL VOLKSWAGEN - ADMINISTRADORA DE CONSÓRCIO LTDA.;Recusa ou demora no fornecimento de documentos (exceto demonstrativos obrigatórios);0;0;5;5;
2020;1º;58919903;CONVEF ADMINISTRADORA DE CONSÓRCIOS LTDA.;Descumprimento de cláusulas referentes à devolução de valores;0;1;0;1;
2020;1º;58919903;CONVEF ADMINISTRADORA DE CONSÓRCIOS LTDA.;Descumprimento de obrigações previstas em contratos;0;2;0;2;
2020;1º;58919903;CONVEF ADMINISTRADORA DE CONSÓRCIOS LTDA.;Descumprimento de prazo de resposta a demanda;0;1;0;1;
2020;1º;58919903;CONVEF ADMINISTRADORA DE CONSÓRCIOS LTDA.;Dificuldade na liberação ou substituição de bem;0;0;1;1;
2020;1º;58919903;CONVEF ADMINISTRADORA DE CONSÓRCIOS LTDA.;Insatisfação com a resposta fornecida pela administradora de consórcio relativa à demanda registrada contra ela;0;1;0;1;
2020;1º;58919903;CONVEF ADMINISTRADORA DE CONSÓRCIOS LTDA.;Irregularidades relacionadas à liberação do crédito;0;4;0;4;
2020;1º;58919903;CONVEF ADMINISTRADORA DE CONSÓRCIOS LTDA.;Outras irregularidades;1;2;0;3;
2020;1º;58919903;CONVEF ADMINISTRADORA DE CONSÓRCIOS LTDA.;Prestação inadequada/insuficiente de informação;0;0;1;1;
2020;1º;58919903;CONVEF ADMINISTRADORA DE CONSÓRCIOS LTDA.;Reclamações relacionadas a assuntos diversos;0;0;2;2;
2020;1º;61550836;COOPERATIVA MISTA JOCKEY CLUB DE SAO PAULO;Descumprimento de cláusulas referentes à devolução de valores;0;2;0;2;
2020;1º;61550836;COOPERATIVA MISTA JOCKEY CLUB DE SAO PAULO;Descumprimento de prazo de resposta a demanda;0;2;0;2;
2020;1º;61550836;COOPERATIVA MISTA JOCKEY CLUB DE SAO PAULO;Insatisfação com a resposta fornecida pela administradora de consórcio relativa à demanda registrada contra ela;1;2;0;3;
2020;1º;61550836;COOPERATIVA MISTA JOCKEY CLUB DE SAO PAULO;Irregularidades relacionadas à liberação do crédito;0;2;0;2;
2020;1º;61550836;COOPERATIVA MISTA JOCKEY CLUB DE SAO PAULO;Irregularidades relacionadas às condições para contemplação por lance ou sorteio;0;1;0;1;
2020;1º;61550836;COOPERATIVA MISTA JOCKEY CLUB DE SAO PAULO;Não fornecimento, remessa ou divulgação de documentos obrigatórios;1;2;0;3;
2020;1º;61550836;COOPERATIVA MISTA JOCKEY CLUB DE SAO PAULO;Outras irregularidades;7;11;0;18;
2020;1º;61550836;COOPERATIVA MISTA JOCKEY CLUB DE SAO PAULO;Prestação inadequada/insuficiente de informação;0;0;1;1;
2020;1º;61550836;COOPERATIVA MISTA JOCKEY CLUB DE SAO PAULO;Publicidade enganosa;0;0;5;5;
2020;1º;61550836;COOPERATIVA MISTA JOCKEY CLUB DE SAO PAULO;Reclamações relacionadas a assuntos diversos;0;0;2;2;
2020;1º;59395061;DISAL ADMINISTRADORA DE CONSÓRCIOS LTDA;Ausência de transparência nas relações contratuais;0;0;1;1;
2020;1º;59395061;DISAL ADMINISTRADORA DE CONSÓRCIOS LTDA;Cobrança irregular de tarifa pela emissão de boletos, carnês e assemelhados;0;2;0;2;
2020;1º;59395061;DISAL ADMINISTRADORA DE CONSÓRCIOS LTDA;Descumprimento de cláusulas referentes à devolução de valores;1;19;0;20;
2020;1º;59395061;DISAL ADMINISTRADORA DE CONSÓRCIOS LTDA;Descumprimento de obrigações previstas em contratos;1;18;0;19;
2020;1º;59395061;DISAL ADMINISTRADORA DE CONSÓRCIOS LTDA;Descumprimento de prazo de resposta a demanda;0;2;0;2;
2020;1º;59395061;DISAL ADMINISTRADORA DE CONSÓRCIOS LTDA;Dificuldade na liberação ou substituição de bem;0;0;9;9;
2020;1º;59395061;DISAL ADMINISTRADORA DE CONSÓRCIOS LTDA;Insatisfação com a resposta fornecida pela administradora de consórcio relativa à demanda registrada contra ela;0;1;0;1;
2020;1º;59395061;DISAL ADMINISTRADORA DE CONSÓRCIOS LTDA;Insatisfação por parte do cliente com o atendimento prestado pela administradora de consórcio;0;0;16;16;
2020;1º;59395061;DISAL ADMINISTRADORA DE CONSÓRCIOS LTDA;Irregularidades relacionadas à liberação do crédito;3;7;0;10;
2020;1º;59395061;DISAL ADMINISTRADORA DE CONSÓRCIOS LTDA;Irregularidades relacionadas às condições para contemplação por lance ou sorteio;0;4;0;4;
2020;1º;59395061;DISAL ADMINISTRADORA DE CONSÓRCIOS LTDA;Não fornecimento, remessa ou divulgação de documentos obrigatórios;2;1;0;3;
2020;1º;59395061;DISAL ADMINISTRADORA DE CONSÓRCIOS LTDA;Outras irregularidades;1;5;0;6;
2020;1º;59395061;DISAL ADMINISTRADORA DE CONSÓRCIOS LTDA;Prestação inadequada/insuficiente de informação;0;0;5;5;
2020;1º;59395061;DISAL ADMINISTRADORA DE CONSÓRCIOS LTDA;Reclamações relacionadas a assuntos diversos;0;0;15;15;
2020;1º;59395061;DISAL ADMINISTRADORA DE CONSÓRCIOS LTDA;Recusa ou demora no fornecimento de documentos (exceto demonstrativos obrigatórios);0;0;9;9;
2020;1º;01659838;DISBRAVE ADMINISTRADORA DE CONSORCIOS LTDA.;Descumprimento de cláusulas referentes à devolução de valores;0;1;0;1;
2020;1º;01659838;DISBRAVE ADMINISTRADORA DE CONSORCIOS LTDA.;Descumprimento de obrigações previstas em contratos;1;2;0;3;
2020;1º;01659838;DISBRAVE ADMINISTRADORA DE CONSORCIOS LTDA.;Insatisfação por parte do cliente com o atendimento prestado pela administradora de consórcio;0;0;1;1;
2020;1º;01659838;DISBRAVE ADMINISTRADORA DE CONSORCIOS LTDA.;Não fornecimento, remessa ou divulgação de documentos obrigatórios;1;0;0;1;
2020;1º;01659838;DISBRAVE ADMINISTRADORA DE CONSORCIOS LTDA.;Recusa ou demora no fornecimento de documentos (exceto demonstrativos obrigatórios);0;0;2;2;
2020;1º;08570707;ELDORADO ADMINISTRADORA DE CONSORCIO LTDA;Prestação inadequada/insuficiente de informação;0;0;1;1;
2020;1º;58113812;EMBRACON ADMINISTRADORA DE CONSÓRCIO LTDA;Ausência de informações/cláusulas obrigatórias em contrato;0;1;0;1;
2020;1º;58113812;EMBRACON ADMINISTRADORA DE CONSÓRCIO LTDA;Ausência de transparência nas relações contratuais;0;0;4;4;
2020;1º;58113812;EMBRACON ADMINISTRADORA DE CONSÓRCIO LTDA;Cobrança irregular de tarifa pela emissão de boletos, carnês e assemelhados;0;1;0;1;
2020;1º;58113812;EMBRACON ADMINISTRADORA DE CONSÓRCIO LTDA;Descumprimento de cláusulas referentes à devolução de valores;0;22;0;22;
2020;1º;58113812;EMBRACON ADMINISTRADORA DE CONSÓRCIO LTDA;Descumprimento de obrigações previstas em contratos;0;11;0;11;
2020;1º;58113812;EMBRACON ADMINISTRADORA DE CONSÓRCIO LTDA;Dificuldade na liberação ou substituição de bem;0;0;2;2;
2020;1º;58113812;EMBRACON ADMINISTRADORA DE CONSÓRCIO LTDA;Insatisfação com a resposta fornecida pela administradora de consórcio relativa à demanda registrada contra ela;0;5;0;5;
2020;1º;58113812;EMBRACON ADMINISTRADORA DE CONSÓRCIO LTDA;Insatisfação por parte do cliente com o atendimento prestado pela administradora de consórcio;0;0;4;4;
2020;1º;58113812;EMBRACON ADMINISTRADORA DE CONSÓRCIO LTDA;Irregularidades relacionadas à liberação do crédito;0;22;0;22;
2020;1º;58113812;EMBRACON ADMINISTRADORA DE CONSÓRCIO LTDA;Irregularidades relacionadas às condições para contemplação por lance ou sorteio;0;13;0;13;
2020;1º;58113812;EMBRACON ADMINISTRADORA DE CONSÓRCIO LTDA;Outras irregularidades;6;15;0;21;
2020;1º;58113812;EMBRACON ADMINISTRADORA DE CONSÓRCIO LTDA;Prestação inadequada/insuficiente de informação;0;0;6;6;
2020;1º;58113812;EMBRACON ADMINISTRADORA DE CONSÓRCIO LTDA;Publicidade enganosa;0;0;4;4;
2020;1º;58113812;EMBRACON ADMINISTRADORA DE CONSÓRCIO LTDA;Reclamações relacionadas a assuntos diversos;0;0;8;8;
2020;1º;58113812;EMBRACON ADMINISTRADORA DE CONSÓRCIO LTDA;Recusa ou demora no fornecimento de documentos (exceto demonstrativos obrigatórios);0;0;3;3;
2020;1º;91107581;FARROUPILHA ADMINISTRADORA DE CONSÓRCIOS LTDA.;Irregularidades relacionadas à liberação do crédito;0;1;0;1;
2020;1º;91107581;FARROUPILHA ADMINISTRADORA DE CONSÓRCIOS LTDA.;Recusa ou demora no fornecimento de documentos (exceto demonstrativos obrigatórios);0;0;1;1;
2020;1º;00600262;FERRAZ ADMINISTRACAO E CONSORCIOS LTDA;Insatisfação por parte do cliente com o atendimento prestado pela administradora de consórcio;0;0;1;1;
2020;1º;45725975;FINAMA ADMINISTRADORA DE CONSORCIO LTDA;Descumprimento de cláusulas referentes à devolução de valores;0;1;0;1;
2020;1º;45725975;FINAMA ADMINISTRADORA DE CONSORCIO LTDA;Irregularidades relacionadas à liberação do crédito;0;3;0;3;
2020;1º;00643742;FUNDACAO HABITACIONAL DO EXERCITO - FHE;Descumprimento de cláusulas referentes à devolução de valores;0;1;0;1;
2020;1º;00643742;FUNDACAO HABITACIONAL DO EXERCITO - FHE;Insatisfação por parte do cliente com o atendimento prestado pela administradora de consórcio;0;0;1;1;
2020;1º;00643742;FUNDACAO HABITACIONAL DO EXERCITO - FHE;Irregularidades relacionadas à liberação do crédito;0;1;0;1;
2020;1º;00643742;FUNDACAO HABITACIONAL DO EXERCITO - FHE;Reclamações relacionadas a assuntos diversos;0;0;3;3;
2020;1º;85322204;GLOBO ADMINISTRADORA DE CONSÓRCIOS LTDA.;Descumprimento de cláusulas referentes à devolução de valores;0;3;0;3;
2020;1º;49937055;GMAC ADMINISTRADORA DE CONSORCIOS LTDA;Descumprimento de cláusulas referentes à devolução de valores;2;10;0;12;
2020;1º;49937055;GMAC ADMINISTRADORA DE CONSORCIOS LTDA;Descumprimento de obrigações previstas em contratos;0;8;0;8;
2020;1º;49937055;GMAC ADMINISTRADORA DE CONSORCIOS LTDA;Descumprimento de prazo de resposta a demanda;0;1;0;1;
2020;1º;49937055;GMAC ADMINISTRADORA DE CONSORCIOS LTDA;Dificuldade na liberação ou substituição de bem;0;0;6;6;
2020;1º;49937055;GMAC ADMINISTRADORA DE CONSORCIOS LTDA;Insatisfação com a resposta fornecida pela administradora de consórcio relativa à demanda registrada contra ela;0;5;0;5;
2020;1º;49937055;GMAC ADMINISTRADORA DE CONSORCIOS LTDA;Insatisfação por parte do cliente com o atendimento prestado pela administradora de consórcio;0;0;5;5;
2020;1º;49937055;GMAC ADMINISTRADORA DE CONSORCIOS LTDA;Irregularidades relacionadas à liberação do crédito;6;30;0;36;
2020;1º;49937055;GMAC ADMINISTRADORA DE CONSORCIOS LTDA;Irregularidades relacionadas às condições para contemplação por lance ou sorteio;0;2;0;2;
2020;1º;49937055;GMAC ADMINISTRADORA DE CONSORCIOS LTDA;Outras irregularidades;4;3;0;7;
2020;1º;49937055;GMAC ADMINISTRADORA DE CONSORCIOS LTDA;Prestação inadequada/insuficiente de informação;0;0;4;4;
2020;1º;49937055;GMAC ADMINISTRADORA DE CONSORCIOS LTDA;Reclamações relacionadas a assuntos diversos;0;0;16;16;
2020;1º;49937055;GMAC ADMINISTRADORA DE CONSORCIOS LTDA;Recusa ou demora no fornecimento de documentos (exceto demonstrativos obrigatórios);0;0;2;2;
2020;1º;02798858;GOVESA ADMINISTRADORA DE CONSÓRCIOS LTDA;Descumprimento de cláusulas referentes à devolução de valores;0;1;0;1;
2020;1º;02798858;GOVESA ADMINISTRADORA DE CONSÓRCIOS LTDA;Descumprimento de obrigações previstas em contratos;0;4;0;4;
2020;1º;02798858;GOVESA ADMINISTRADORA DE CONSÓRCIOS LTDA;Descumprimento de prazo de resposta a demanda;1;0;0;1;
2020;1º;02798858;GOVESA ADMINISTRADORA DE CONSÓRCIOS LTDA;Insatisfação por parte do cliente com o atendimento prestado pela administradora de consórcio;0;0;1;1;
2020;1º;02798858;GOVESA ADMINISTRADORA DE CONSÓRCIOS LTDA;Irregularidades relacionadas às condições para contemplação por lance ou sorteio;0;1;0;1;
2020;1º;02798858;GOVESA ADMINISTRADORA DE CONSÓRCIOS LTDA;Outras irregularidades;1;1;0;2;
2020;1º;02798858;GOVESA ADMINISTRADORA DE CONSÓRCIOS LTDA;Outras irregularidades relacionadas à Ouvidoria;0;1;0;1;
2020;1º;02798858;GOVESA ADMINISTRADORA DE CONSÓRCIOS LTDA;Prestação inadequada/insuficiente de informação;0;0;4;4;
2020;1º;02798858;GOVESA ADMINISTRADORA DE CONSÓRCIOS LTDA;Reclamações relacionadas a assuntos diversos;0;0;3;3;
2020;1º;26228270;GROSCON ADMINISTRADORA DE CONSORCIOS LTDA.;Prestação inadequada/insuficiente de informação;0;0;1;1;
2020;1º;73516106;HS ADMINISTRADORA DE CONSÓRCIOS LTDA;Cobrança irregular de tarifa pela emissão de boletos, carnês e assemelhados;0;1;0;1;
2020;1º;73516106;HS ADMINISTRADORA DE CONSÓRCIOS LTDA;Descumprimento de obrigações previstas em contratos;0;2;0;2;
2020;1º;73516106;HS ADMINISTRADORA DE CONSÓRCIOS LTDA;Irregularidades relacionadas à liberação do crédito;0;1;0;1;
2020;1º;73516106;HS ADMINISTRADORA DE CONSÓRCIOS LTDA;Irregularidades relacionadas às condições para contemplação por lance ou sorteio;0;1;0;1;
2020;1º;73516106;HS ADMINISTRADORA DE CONSÓRCIOS LTDA;Reclamações relacionadas a assuntos diversos;0;0;7;7;
2020;1º;06181431;ITAUNA ADMINISTRADORA DE CONSORCIO LTDA;Descumprimento de cláusulas referentes à devolução de valores;0;2;0;2;
2020;1º;06181431;ITAUNA ADMINISTRADORA DE CONSORCIO LTDA;Irregularidades relacionadas à liberação do crédito;0;1;0;1;
2020;1º;06181431;ITAUNA ADMINISTRADORA DE CONSORCIO LTDA;Reclamações relacionadas a assuntos diversos;0;0;1;1;
2020;1º;06181431;ITAUNA ADMINISTRADORA DE CONSORCIO LTDA;Recusa ou demora no fornecimento de documentos (exceto demonstrativos obrigatórios);0;0;1;1;
2020;1º;00000776;ITAÚ ADMINISTRADORA DE CONSÓRCIOS LTDA.;Ausência de transparência nas relações contratuais;0;0;1;1;
2020;1º;00000776;ITAÚ ADMINISTRADORA DE CONSÓRCIOS LTDA.;Descumprimento de cláusulas referentes à devolução de valores;5;57;0;62;
2020;1º;00000776;ITAÚ ADMINISTRADORA DE CONSÓRCIOS LTDA.;Descumprimento de obrigações previstas em contratos;13;27;0;40;
2020;1º;00000776;ITAÚ ADMINISTRADORA DE CONSÓRCIOS LTDA.;Descumprimento de prazo de resposta a demanda;2;2;0;4;
2020;1º;00000776;ITAÚ ADMINISTRADORA DE CONSÓRCIOS LTDA.;Dificuldade na liberação ou substituição de bem;0;0;1;1;
2020;1º;00000776;ITAÚ ADMINISTRADORA DE CONSÓRCIOS LTDA.;Insatisfação com a resposta fornecida pela administradora de consórcio relativa à demanda registrada contra ela;0;6;0;6;
2020;1º;00000776;ITAÚ ADMINISTRADORA DE CONSÓRCIOS LTDA.;Insatisfação por parte do cliente com o atendimento prestado pela administradora de consórcio;0;0;6;6;
2020;1º;00000776;ITAÚ ADMINISTRADORA DE CONSÓRCIOS LTDA.;Irregularidades relacionadas à liberação do crédito;8;43;0;51;
2020;1º;00000776;ITAÚ ADMINISTRADORA DE CONSÓRCIOS LTDA.;Irregularidades relacionadas às condições para contemplação por lance ou sorteio;4;4;0;8;
2020;1º;00000776;ITAÚ ADMINISTRADORA DE CONSÓRCIOS LTDA.;Não fornecimento, remessa ou divulgação de documentos obrigatórios;0;2;0;2;
2020;1º;00000776;ITAÚ ADMINISTRADORA DE CONSÓRCIOS LTDA.;Outras irregularidades;5;9;0;14;
2020;1º;00000776;ITAÚ ADMINISTRADORA DE CONSÓRCIOS LTDA.;Prestação inadequada/insuficiente de informação;0;0;12;12;
2020;1º;00000776;ITAÚ ADMINISTRADORA DE CONSÓRCIOS LTDA.;Reclamações relacionadas a assuntos diversos;0;0;21;21;
2020;1º;00000776;ITAÚ ADMINISTRADORA DE CONSÓRCIOS LTDA.;Recusa ou demora no fornecimento de documentos (exceto demonstrativos obrigatórios);0;0;9;9;
2020;1º;42421776;ITAÚ UNIBANCO VEÍCULOS ADMINISTRADORA DE CONSÓRCIOS LTDA.;Descumprimento de cláusulas referentes à devolução de valores;0;7;0;7;
2020;1º;42421776;ITAÚ UNIBANCO VEÍCULOS ADMINISTRADORA DE CONSÓRCIOS LTDA.;Dificuldade na liberação ou substituição de bem;0;0;1;1;
2020;1º;42421776;ITAÚ UNIBANCO VEÍCULOS ADMINISTRADORA DE CONSÓRCIOS LTDA.;Insatisfação por parte do cliente com o atendimento prestado pela administradora de consórcio;0;0;1;1;
2020;1º;42421776;ITAÚ UNIBANCO VEÍCULOS ADMINISTRADORA DE CONSÓRCIOS LTDA.;Irregularidades relacionadas à liberação do crédito;0;5;0;5;
2020;1º;42421776;ITAÚ UNIBANCO VEÍCULOS ADMINISTRADORA DE CONSÓRCIOS LTDA.;Outras irregularidades;0;1;0;1;
2020;1º;42421776;ITAÚ UNIBANCO VEÍCULOS ADMINISTRADORA DE CONSÓRCIOS LTDA.;Reclamações relacionadas a assuntos diversos;0;0;1;1;
2020;1º;60250776;LUIZA ADMINISTRADORA DE CONSÓRCIOS LTDA;Descumprimento de obrigações previstas em contratos;0;2;0;2;
2020;1º;60250776;LUIZA ADMINISTRADORA DE CONSÓRCIOS LTDA;Irregularidades relacionadas à liberação do crédito;0;1;0;1;
2020;1º;60250776;LUIZA ADMINISTRADORA DE CONSÓRCIOS LTDA;Irregularidades relacionadas às condições para contemplação por lance ou sorteio;0;3;0;3;
2020;1º;60250776;LUIZA ADMINISTRADORA DE CONSÓRCIOS LTDA;Prestação inadequada/insuficiente de informação;0;0;2;2;
2020;1º;60250776;LUIZA ADMINISTRADORA DE CONSÓRCIOS LTDA;Reclamações relacionadas a assuntos diversos;0;0;2;2;
2020;1º;04250224;MAGGI ADMINISTRADORA DE CONSÓRCIOS LTDA;Reclamações relacionadas a assuntos diversos;0;0;1;1;
2020;1º;45793395;MASSEY FERGUSON ADMINISTRADORA DE CONSÓRCIOS LTDA;Insatisfação com a resposta fornecida pela administradora de consórcio relativa à demanda registrada contra ela;0;1;0;1;
2020;1º;45793395;MASSEY FERGUSON ADMINISTRADORA DE CONSÓRCIOS LTDA;Prestação inadequada/insuficiente de informação;0;0;1;1;
2020;1º;46349106;MERCABENCO ADMINISTRADORA DE CONSORCIO LTDA;Descumprimento de cláusulas referentes à devolução de valores;1;0;0;1;
2020;1º;46349106;MERCABENCO ADMINISTRADORA DE CONSORCIO LTDA;Descumprimento de obrigações previstas em contratos;1;0;0;1;
2020;1º;46349106;MERCABENCO ADMINISTRADORA DE CONSORCIO LTDA;Insatisfação com a resposta fornecida pela administradora de consórcio relativa à demanda registrada contra ela;0;2;0;2;
2020;1º;46349106;MERCABENCO ADMINISTRADORA DE CONSORCIO LTDA;Recusa ou demora no fornecimento de documentos (exceto demonstrativos obrigatórios);0;0;1;1;
2020;1º;04124922;MULTIMARCAS ADMINISTRADORA DE CONSORCIOS LTDA.;Ausência de transparência nas relações contratuais;0;0;1;1;
2020;1º;04124922;MULTIMARCAS ADMINISTRADORA DE CONSORCIOS LTDA.;Descumprimento de cláusulas referentes à devolução de valores;2;8;0;10;
2020;1º;04124922;MULTIMARCAS ADMINISTRADORA DE CONSORCIOS LTDA.;Descumprimento de obrigações previstas em contratos;1;1;0;2;
2020;1º;04124922;MULTIMARCAS ADMINISTRADORA DE CONSORCIOS LTDA.;Descumprimento de prazo de resposta a demanda;0;1;0;1;
2020;1º;04124922;MULTIMARCAS ADMINISTRADORA DE CONSORCIOS LTDA.;Insatisfação com a resposta fornecida pela administradora de consórcio relativa à demanda registrada contra ela;0;3;0;3;
2020;1º;04124922;MULTIMARCAS ADMINISTRADORA DE CONSORCIOS LTDA.;Irregularidades relacionadas à liberação do crédito;0;1;0;1;
2020;1º;04124922;MULTIMARCAS ADMINISTRADORA DE CONSORCIOS LTDA.;Outras irregularidades;22;25;0;47;
2020;1º;04124922;MULTIMARCAS ADMINISTRADORA DE CONSORCIOS LTDA.;Prestação inadequada/insuficiente de informação;0;0;2;2;
2020;1º;04124922;MULTIMARCAS ADMINISTRADORA DE CONSORCIOS LTDA.;Publicidade enganosa;0;0;1;1;
2020;1º;04124922;MULTIMARCAS ADMINISTRADORA DE CONSORCIOS LTDA.;Reclamações relacionadas a assuntos diversos;0;0;1;1;
2020;1º;50533876;PAN ADMINISTRADORA DE CONSORCIO LTDA;Descumprimento de cláusulas referentes à devolução de valores;0;6;0;6;
2020;1º;50533876;PAN ADMINISTRADORA DE CONSORCIO LTDA;Descumprimento de obrigações previstas em contratos;1;0;0;1;
2020;1º;50533876;PAN ADMINISTRADORA DE CONSORCIO LTDA;Dificuldade na liberação ou substituição de bem;0;0;1;1;
2020;1º;50533876;PAN ADMINISTRADORA DE CONSORCIO LTDA;Insatisfação com a resposta fornecida pela administradora de consórcio relativa à demanda registrada contra ela;1;2;0;3;
2020;1º;50533876;PAN ADMINISTRADORA DE CONSORCIO LTDA;Insatisfação por parte do cliente com o atendimento prestado pela administradora de consórcio;0;0;1;1;
2020;1º;50533876;PAN ADMINISTRADORA DE CONSORCIO LTDA;Irregularidades relacionadas à liberação do crédito;2;2;0;4;
2020;1º;50533876;PAN ADMINISTRADORA DE CONSORCIO LTDA;Não fornecimento, remessa ou divulgação de documentos obrigatórios;0;2;0;2;
2020;1º;50533876;PAN ADMINISTRADORA DE CONSORCIO LTDA;Outras irregularidades;1;3;0;4;
2020;1º;50533876;PAN ADMINISTRADORA DE CONSORCIO LTDA;Prestação inadequada/insuficiente de informação;0;0;3;3;
2020;1º;50533876;PAN ADMINISTRADORA DE CONSORCIO LTDA;Publicidade enganosa;0;0;1;1;
2020;1º;50533876;PAN ADMINISTRADORA DE CONSORCIO LTDA;Reclamações relacionadas a assuntos diversos;0;0;1;1;
2020;1º;50533876;PAN ADMINISTRADORA DE CONSORCIO LTDA;Recusa ou demora no fornecimento de documentos (exceto demonstrativos obrigatórios);0;0;3;3;
2020;1º;16551061;PONTA ADMINISTRADORA DE CONSORCIOS LTDA;Ausência de transparência nas relações contratuais;0;0;1;1;
2020;1º;16551061;PONTA ADMINISTRADORA DE CONSORCIOS LTDA;Descumprimento de cláusulas referentes à devolução de valores;0;5;0;5;
2020;1º;16551061;PONTA ADMINISTRADORA DE CONSORCIOS LTDA;Descumprimento de obrigações previstas em contratos;1;5;0;6;
2020;1º;16551061;PONTA ADMINISTRADORA DE CONSORCIOS LTDA;Dificuldade na liberação ou substituição de bem;0;0;2;2;
2020;1º;16551061;PONTA ADMINISTRADORA DE CONSORCIOS LTDA;Insatisfação com a resposta fornecida pela administradora de consórcio relativa à demanda registrada contra ela;0;1;0;1;
2020;1º;16551061;PONTA ADMINISTRADORA DE CONSORCIOS LTDA;Insatisfação por parte do cliente com o atendimento prestado pela administradora de consórcio;0;0;2;2;
2020;1º;16551061;PONTA ADMINISTRADORA DE CONSORCIOS LTDA;Irregularidades relacionadas à liberação do crédito;0;5;0;5;
2020;1º;16551061;PONTA ADMINISTRADORA DE CONSORCIOS LTDA;Irregularidades relacionadas às condições para contemplação por lance ou sorteio;0;3;0;3;
2020;1º;16551061;PONTA ADMINISTRADORA DE CONSORCIOS LTDA;Reclamações relacionadas a assuntos diversos;0;0;7;7;
2020;1º;48041735;PORTO SEGURO ADMINISTRADORA DE CONSÓRCIOS LTDA;Ausência de informações/cláusulas obrigatórias em contrato;1;0;0;1;
2020;1º;48041735;PORTO SEGURO ADMINISTRADORA DE CONSÓRCIOS LTDA;Cobrança irregular de tarifa pela emissão de boletos, carnês e assemelhados;1;0;0;1;
2020;1º;48041735;PORTO SEGURO ADMINISTRADORA DE CONSÓRCIOS LTDA;Descumprimento de cláusulas referentes à devolução de valores;1;7;0;8;
2020;1º;48041735;PORTO SEGURO ADMINISTRADORA DE CONSÓRCIOS LTDA;Descumprimento de obrigações previstas em contratos;3;10;0;13;
2020;1º;48041735;PORTO SEGURO ADMINISTRADORA DE CONSÓRCIOS LTDA;Dificuldade na liberação ou substituição de bem;0;0;1;1;
2020;1º;48041735;PORTO SEGURO ADMINISTRADORA DE CONSÓRCIOS LTDA;Insatisfação por parte do cliente com o atendimento prestado pela administradora de consórcio;0;0;3;3;
2020;1º;48041735;PORTO SEGURO ADMINISTRADORA DE CONSÓRCIOS LTDA;Irregularidades relacionadas à liberação do crédito;0;5;0;5;
2020;1º;48041735;PORTO SEGURO ADMINISTRADORA DE CONSÓRCIOS LTDA;Irregularidades relacionadas às condições para contemplação por lance ou sorteio;0;3;0;3;
2020;1º;48041735;PORTO SEGURO ADMINISTRADORA DE CONSÓRCIOS LTDA;Não fornecimento, remessa ou divulgação de documentos obrigatórios;1;0;0;1;
2020;1º;48041735;PORTO SEGURO ADMINISTRADORA DE CONSÓRCIOS LTDA;Outras irregularidades;1;4;0;5;
2020;1º;48041735;PORTO SEGURO ADMINISTRADORA DE CONSÓRCIOS LTDA;Prestação inadequada/insuficiente de informação;0;0;6;6;
2020;1º;48041735;PORTO SEGURO ADMINISTRADORA DE CONSÓRCIOS LTDA;Reclamações relacionadas a assuntos diversos;0;0;18;18;
2020;1º;48041735;PORTO SEGURO ADMINISTRADORA DE CONSÓRCIOS LTDA;Recusa ou demora no fornecimento de documentos (exceto demonstrativos obrigatórios);0;0;3;3;
2020;1º;87433413;PORTOBENS ADMINISTRADORA DE CONSORCIOS LTDA;Outras irregularidades;1;0;0;1;
2020;1º;87433413;PORTOBENS ADMINISTRADORA DE CONSORCIOS LTDA;Prestação inadequada/insuficiente de informação;0;0;1;1;
2020;1º;51597300;PRIMO ROSSI ADMINISTRADORA DE CONSÓRCIO LTDA.;Cobrança irregular de tarifa pela emissão de boletos, carnês e assemelhados;0;1;0;1;
2020;1º;51597300;PRIMO ROSSI ADMINISTRADORA DE CONSÓRCIO LTDA.;Descumprimento de cláusulas referentes à devolução de valores;0;1;0;1;
2020;1º;51597300;PRIMO ROSSI ADMINISTRADORA DE CONSÓRCIO LTDA.;Descumprimento de obrigações previstas em contratos;0;1;0;1;
2020;1º;51597300;PRIMO ROSSI ADMINISTRADORA DE CONSÓRCIO LTDA.;Insatisfação com a resposta fornecida pela administradora de consórcio relativa à demanda registrada contra ela;0;1;0;1;
2020;1º;51597300;PRIMO ROSSI ADMINISTRADORA DE CONSÓRCIO LTDA.;Irregularidades relacionadas à liberação do crédito;1;0;0;1;
2020;1º;51597300;PRIMO ROSSI ADMINISTRADORA DE CONSÓRCIO LTDA.;Reclamações relacionadas a assuntos diversos;0;0;2;2;
2020;1º;51597300;PRIMO ROSSI ADMINISTRADORA DE CONSÓRCIO LTDA.;Recusa ou demora no fornecimento de documentos (exceto demonstrativos obrigatórios);0;0;1;1;
2020;1º;91108027;RANDON ADMINISTRADORA DE CONSÓRCIOS LTDA.;Descumprimento de cláusulas referentes à devolução de valores;0;1;0;1;
2020;1º;91108027;RANDON ADMINISTRADORA DE CONSÓRCIOS LTDA.;Dificuldade na liberação ou substituição de bem;0;0;1;1;
2020;1º;91108027;RANDON ADMINISTRADORA DE CONSÓRCIOS LTDA.;Irregularidades relacionadas à liberação do crédito;1;3;0;4;
2020;1º;91108027;RANDON ADMINISTRADORA DE CONSÓRCIOS LTDA.;Outras irregularidades;1;0;0;1;
2020;1º;66228966;REALIZA ADMINISTRADORA DE CONSÓRCIOS LTDA.;Descumprimento de cláusulas referentes à devolução de valores;0;5;0;5;
2020;1º;66228966;REALIZA ADMINISTRADORA DE CONSÓRCIOS LTDA.;Descumprimento de prazo de resposta a demanda;0;1;0;1;
2020;1º;66228966;REALIZA ADMINISTRADORA DE CONSÓRCIOS LTDA.;Insatisfação por parte do cliente com o atendimento prestado pela administradora de consórcio;0;0;1;1;
2020;1º;66228966;REALIZA ADMINISTRADORA DE CONSÓRCIOS LTDA.;Irregularidades relacionadas às condições para contemplação por lance ou sorteio;0;2;0;2;
2020;1º;66228966;REALIZA ADMINISTRADORA DE CONSÓRCIOS LTDA.;Não fornecimento, remessa ou divulgação de documentos obrigatórios;0;1;0;1;
2020;1º;66228966;REALIZA ADMINISTRADORA DE CONSÓRCIOS LTDA.;Outras irregularidades;0;1;0;1;
2020;1º;66228966;REALIZA ADMINISTRADORA DE CONSÓRCIOS LTDA.;Recusa ou demora no fornecimento de documentos (exceto demonstrativos obrigatórios);0;0;1;1;
2020;1º;23767155;RECON ADMINISTRADORA DE CONSORCIOS LTDA;Ausência de informações/cláusulas obrigatórias em contrato;1;0;0;1;
2020;1º;23767155;RECON ADMINISTRADORA DE CONSORCIOS LTDA;Descumprimento de cláusulas referentes à devolução de valores;0;1;0;1;
2020;1º;23767155;RECON ADMINISTRADORA DE CONSORCIOS LTDA;Insatisfação com a resposta fornecida pela administradora de consórcio relativa à demanda registrada contra ela;1;0;0;1;
2020;1º;23767155;RECON ADMINISTRADORA DE CONSORCIOS LTDA;Outras irregularidades;0;1;0;1;
2020;1º;92002609;REDE OESTE ADMINISTRADORA DE CONSORCIOS LTDA.;Descumprimento de prazo de resposta a demanda;1;0;0;1;
2020;1º;92002609;REDE OESTE ADMINISTRADORA DE CONSORCIOS LTDA.;Insatisfação com a resposta fornecida pela administradora de consórcio relativa à demanda registrada contra ela;0;1;0;1;
2020;1º;92002609;REDE OESTE ADMINISTRADORA DE CONSORCIOS LTDA.;Prestação inadequada/insuficiente de informação;0;0;1;1;
2020;1º;62354055;REMAZA ADMINISTRADORA DE CONSÓRCIO LTDA.;Descumprimento de cláusulas referentes à devolução de valores;0;8;0;8;
2020;1º;62354055;REMAZA ADMINISTRADORA DE CONSÓRCIO LTDA.;Descumprimento de prazo de resposta a demanda;0;1;0;1;
2020;1º;62354055;REMAZA ADMINISTRADORA DE CONSÓRCIO LTDA.;Dificuldade na liberação ou substituição de bem;0;0;1;1;
2020;1º;62354055;REMAZA ADMINISTRADORA DE CONSÓRCIO LTDA.;Insatisfação com a resposta fornecida pela administradora de consórcio relativa à demanda registrada contra ela;0;2;0;2;
2020;1º;62354055;REMAZA ADMINISTRADORA DE CONSÓRCIO LTDA.;Irregularidades relacionadas à liberação do crédito;0;2;0;2;
2020;1º;62354055;REMAZA ADMINISTRADORA DE CONSÓRCIO LTDA.;Irregularidades relacionadas às condições para contemplação por lance ou sorteio;0;2;0;2;
2020;1º;62354055;REMAZA ADMINISTRADORA DE CONSÓRCIO LTDA.;Outras irregularidades;0;6;0;6;
2020;1º;62354055;REMAZA ADMINISTRADORA DE CONSÓRCIO LTDA.;Reclamações relacionadas a assuntos diversos;0;0;4;4;
2020;1º;62354055;REMAZA ADMINISTRADORA DE CONSÓRCIO LTDA.;Recusa ou demora no fornecimento de documentos (exceto demonstrativos obrigatórios);0;0;1;1;
2020;1º;28904092;RESERVA ADMINISTRADORA DE CONSÓRCIO LTDA;Descumprimento de cláusulas referentes à devolução de valores;0;1;0;1;
2020;1º;28904092;RESERVA ADMINISTRADORA DE CONSÓRCIO LTDA;Descumprimento de obrigações previstas em contratos;2;1;0;3;
2020;1º;28904092;RESERVA ADMINISTRADORA DE CONSÓRCIO LTDA;Insatisfação com a resposta fornecida pela administradora de consórcio relativa à demanda registrada contra ela;0;2;0;2;
2020;1º;28904092;RESERVA ADMINISTRADORA DE CONSÓRCIO LTDA;Irregularidades relacionadas à liberação do crédito;0;1;0;1;
2020;1º;28904092;RESERVA ADMINISTRADORA DE CONSÓRCIO LTDA;Irregularidades relacionadas às condições para contemplação por lance ou sorteio;0;3;0;3;
2020;1º;28904092;RESERVA ADMINISTRADORA DE CONSÓRCIO LTDA;Outras irregularidades;13;25;0;38;
2020;1º;28904092;RESERVA ADMINISTRADORA DE CONSÓRCIO LTDA;Prestação inadequada/insuficiente de informação;0;0;2;2;
2020;1º;28904092;RESERVA ADMINISTRADORA DE CONSÓRCIO LTDA;Publicidade enganosa;0;0;1;1;
2020;1º;51855716;RODOBENS ADMINISTRADORA DE CONSÓRCIOS LTDA.;Descumprimento de cláusulas referentes à devolução de valores;1;12;0;13;
2020;1º;51855716;RODOBENS ADMINISTRADORA DE CONSÓRCIOS LTDA.;Descumprimento de obrigações previstas em contratos;1;8;0;9;
2020;1º;51855716;RODOBENS ADMINISTRADORA DE CONSÓRCIOS LTDA.;Golpe;0;0;1;1;
2020;1º;51855716;RODOBENS ADMINISTRADORA DE CONSÓRCIOS LTDA.;Insatisfação com a resposta fornecida pela administradora de consórcio relativa à demanda registrada contra ela;0;4;0;4;
2020;1º;51855716;RODOBENS ADMINISTRADORA DE CONSÓRCIOS LTDA.;Insatisfação por parte do cliente com o atendimento prestado pela administradora de consórcio;0;0;3;3;
2020;1º;51855716;RODOBENS ADMINISTRADORA DE CONSÓRCIOS LTDA.;Irregularidades relacionadas à liberação do crédito;0;10;0;10;
2020;1º;51855716;RODOBENS ADMINISTRADORA DE CONSÓRCIOS LTDA.;Irregularidades relacionadas às condições para contemplação por lance ou sorteio;0;1;0;1;
2020;1º;51855716;RODOBENS ADMINISTRADORA DE CONSÓRCIOS LTDA.;Não fornecimento, remessa ou divulgação de documentos obrigatórios;0;1;0;1;
2020;1º;51855716;RODOBENS ADMINISTRADORA DE CONSÓRCIOS LTDA.;Outras irregularidades;2;2;0;4;
2020;1º;51855716;RODOBENS ADMINISTRADORA DE CONSÓRCIOS LTDA.;Prestação inadequada/insuficiente de informação;0;0;3;3;
2020;1º;51855716;RODOBENS ADMINISTRADORA DE CONSÓRCIOS LTDA.;Reclamações relacionadas a assuntos diversos;0;0;7;7;
2020;1º;51855716;RODOBENS ADMINISTRADORA DE CONSÓRCIOS LTDA.;Recusa ou demora no fornecimento de documentos (exceto demonstrativos obrigatórios);0;0;1;1;
2020;1º;55942312;SANTANDER BRASIL ADMINISTRADORA DE CONSÓRCIO LTDA.;Ausência de transparência nas relações contratuais;0;0;3;3;
2020;1º;55942312;SANTANDER BRASIL ADMINISTRADORA DE CONSÓRCIO LTDA.;Descumprimento de cláusulas referentes à devolução de valores;2;7;0;9;
2020;1º;55942312;SANTANDER BRASIL ADMINISTRADORA DE CONSÓRCIO LTDA.;Descumprimento de obrigações previstas em contratos;2;14;0;16;
2020;1º;55942312;SANTANDER BRASIL ADMINISTRADORA DE CONSÓRCIO LTDA.;Descumprimento de prazo de resposta a demanda;0;1;0;1;
2020;1º;55942312;SANTANDER BRASIL ADMINISTRADORA DE CONSÓRCIO LTDA.;Dificuldade na liberação ou substituição de bem;0;0;3;3;
2020;1º;55942312;SANTANDER BRASIL ADMINISTRADORA DE CONSÓRCIO LTDA.;Insatisfação com a resposta fornecida pela administradora de consórcio relativa à demanda registrada contra ela;1;4;0;5;
2020;1º;55942312;SANTANDER BRASIL ADMINISTRADORA DE CONSÓRCIO LTDA.;Insatisfação por parte do cliente com o atendimento prestado pela administradora de consórcio;0;0;8;8;
2020;1º;55942312;SANTANDER BRASIL ADMINISTRADORA DE CONSÓRCIO LTDA.;Irregularidades relacionadas à liberação do crédito;2;32;0;34;
2020;1º;55942312;SANTANDER BRASIL ADMINISTRADORA DE CONSÓRCIO LTDA.;Irregularidades relacionadas às condições para contemplação por lance ou sorteio;1;2;0;3;
2020;1º;55942312;SANTANDER BRASIL ADMINISTRADORA DE CONSÓRCIO LTDA.;Não fornecimento, remessa ou divulgação de documentos obrigatórios;3;2;0;5;
2020;1º;55942312;SANTANDER BRASIL ADMINISTRADORA DE CONSÓRCIO LTDA.;Outras irregularidades;7;4;0;11;
2020;1º;55942312;SANTANDER BRASIL ADMINISTRADORA DE CONSÓRCIO LTDA.;Prestação inadequada/insuficiente de informação;0;0;7;7;
2020;1º;55942312;SANTANDER BRASIL ADMINISTRADORA DE CONSÓRCIO LTDA.;Publicidade enganosa;0;0;1;1;
2020;1º;55942312;SANTANDER BRASIL ADMINISTRADORA DE CONSÓRCIO LTDA.;Reclamações relacionadas a assuntos diversos;0;0;21;21;
2020;1º;55942312;SANTANDER BRASIL ADMINISTRADORA DE CONSÓRCIO LTDA.;Recusa ou demora no fornecimento de documentos (exceto demonstrativos obrigatórios);0;0;3;3;
2020;1º;96479258;SCANIA ADMINISTRADORA DE CONSÓRCIOS LTDA.;Irregularidades relacionadas à liberação do crédito;0;1;0;1;
2020;1º;96479258;SCANIA ADMINISTRADORA DE CONSÓRCIOS LTDA.;Prestação inadequada/insuficiente de informação;0;0;1;1;
2020;1º;96479258;SCANIA ADMINISTRADORA DE CONSÓRCIOS LTDA.;Reclamações relacionadas a assuntos diversos;0;0;2;2;
2020;1º;76515071;SERVOPA ADMINISTRADORA DE CONSORCIOS LTDA;Descumprimento de obrigações previstas em contratos;1;1;0;2;
2020;1º;76515071;SERVOPA ADMINISTRADORA DE CONSORCIOS LTDA;Irregularidades relacionadas à liberação do crédito;0;1;0;1;
2020;1º;76515071;SERVOPA ADMINISTRADORA DE CONSORCIOS LTDA;Irregularidades relacionadas às condições para contemplação por lance ou sorteio;0;1;0;1;
2020;1º;76515071;SERVOPA ADMINISTRADORA DE CONSORCIOS LTDA;Prestação inadequada/insuficiente de informação;0;0;1;1;
2020;1º;76515071;SERVOPA ADMINISTRADORA DE CONSORCIOS LTDA;Reclamações relacionadas a assuntos diversos;0;0;1;1;
2020;1º;57723801;SUZUKI MOTOS ADMINISTRADORA DE CONSÓRCIO LTDA.;Prestação inadequada/insuficiente de informação;0;0;1;1;
2020;1º;53211488;TARRAF ADMINISTRADORA DE CONSÓRCIOS LTDA.;Irregularidades relacionadas às condições para contemplação por lance ou sorteio;0;1;0;1;
2020;1º;53211488;TARRAF ADMINISTRADORA DE CONSÓRCIOS LTDA.;Outras irregularidades;0;1;0;1;
2020;1º;59956185;TRADIÇÃO ADMINISTRADORA DE CONSÓRCIO LTDA.;Descumprimento de cláusulas referentes à devolução de valores;0;1;0;1;
2020;1º;59956185;TRADIÇÃO ADMINISTRADORA DE CONSÓRCIO LTDA.;Irregularidades relacionadas à liberação do crédito;0;1;0;1;
2020;1º;59956185;TRADIÇÃO ADMINISTRADORA DE CONSÓRCIO LTDA.;Outras irregularidades;0;1;0;1;
2020;1º;78199262;TRIÂNGULO ADMINISTRADORA DE CONSÓRCIOS LTDA;Reclamações relacionadas a assuntos diversos;0;0;1;1;
2020;1º;60732997;UNIFISA ADMINISTRADORA NACIONAL DE CONSORCIOS LTDA;Descumprimento de obrigações previstas em contratos;0;1;0;1;
2020;1º;60732997;UNIFISA ADMINISTRADORA NACIONAL DE CONSORCIOS LTDA;Insatisfação com a resposta fornecida pela administradora de consórcio relativa à demanda registrada contra ela;0;2;0;2;
2020;1º;60732997;UNIFISA ADMINISTRADORA NACIONAL DE CONSORCIOS LTDA;Irregularidades relacionadas à liberação do crédito;0;1;0;1;
2020;1º;60732997;UNIFISA ADMINISTRADORA NACIONAL DE CONSORCIOS LTDA;Irregularidades relacionadas às condições para contemplação por lance ou sorteio;0;1;0;1;
2020;1º;60732997;UNIFISA ADMINISTRADORA NACIONAL DE CONSORCIOS LTDA;Outras irregularidades;0;1;0;1;
2020;1º;60732997;UNIFISA ADMINISTRADORA NACIONAL DE CONSORCIOS LTDA;Publicidade enganosa;0;0;1;1;
2020;1º;60732997;UNIFISA ADMINISTRADORA NACIONAL DE CONSORCIOS LTDA;Recusa ou demora no fornecimento de documentos (exceto demonstrativos obrigatórios);0;0;1;1;
2020;1º;56360266;VALTRA ADMINISTRADORA DE CONSÓRCIOS LTDA;Insatisfação por parte do cliente com o atendimento prestado pela administradora de consórcio;0;0;1;1;
2020;1º;50827237;VKN ADMINISTRADORA DE CONSÓRCIO LTDA.;Outras irregularidades;1;0;0;1;
2020;1º;50827237;VKN ADMINISTRADORA DE CONSÓRCIO LTDA.;Reclamações relacionadas a assuntos diversos;0;0;1;1;
2020;1º;74118381;VOLVO ADMINISTRADORA DE CONSÓRCIO LTDA.;Descumprimento de cláusulas referentes à devolução de valores;1;0;0;1;
2020;1º;74118381;VOLVO ADMINISTRADORA DE CONSÓRCIO LTDA.;Dificuldade na liberação ou substituição de bem;0;0;1;1;
2020;1º;74118381;VOLVO ADMINISTRADORA DE CONSÓRCIO LTDA.;Reclamações relacionadas a assuntos diversos;0;0;1;1;
2020;1º;47458153;YAMAHA ADMINISTRADORA DE CONSÓRCIO LTDA.;Descumprimento de cláusulas referentes à devolução de valores;0;4;0;4;
2020;1º;47458153;YAMAHA ADMINISTRADORA DE CONSÓRCIO LTDA.;Descumprimento de obrigações previstas em contratos;1;4;0;5;
2020;1º;47458153;YAMAHA ADMINISTRADORA DE CONSÓRCIO LTDA.;Dificuldade na liberação ou substituição de bem;0;0;2;2;
2020;1º;47458153;YAMAHA ADMINISTRADORA DE CONSÓRCIO LTDA.;Irregularidades relacionadas à liberação do crédito;1;6;0;7;
2020;1º;47458153;YAMAHA ADMINISTRADORA DE CONSÓRCIO LTDA.;Outras irregularidades;1;0;0;1;
2020;1º;47458153;YAMAHA ADMINISTRADORA DE CONSÓRCIO LTDA.;Prestação inadequada/insuficiente de informação;0;0;2;2;
2020;1º;47458153;YAMAHA ADMINISTRADORA DE CONSÓRCIO LTDA.;Reclamações relacionadas a assuntos diversos;0;0;1;1;
2020;1º;23367634;ZEMA ADMINISTRADORA DE CONSÓRCIO LTDA;Descumprimento de cláusulas referentes à devolução de valores;1;0;0;1;
2020;1º;23367634;ZEMA ADMINISTRADORA DE CONSÓRCIO LTDA;Descumprimento de obrigações previstas em contratos;0;1;0;1;
2020;1º;23367634;ZEMA ADMINISTRADORA DE CONSÓRCIO LTDA;Irregularidades relacionadas à liberação do crédito;0;1;0;1;
2020;1º;23367634;ZEMA ADMINISTRADORA DE CONSÓRCIO LTDA;Outras irregularidades;1;2;0;3;
2020;1º;23367634;ZEMA ADMINISTRADORA DE CONSÓRCIO LTDA;Publicidade enganosa;0;0;1;1;
2020;1º;23367634;ZEMA ADMINISTRADORA DE CONSÓRCIO LTDA;Reclamações relacionadas a assuntos diversos;0;0;1;1;
