Ano;Semestre;CNPJ AC;Administradora de consórcio;Irregularidade;Quantidade de reclamações reguladas procedentes;Quantidade de reclamações reguladas - outras;Quantidade de reclamações não reguladas;Quantidade total de reclamações;
2019;2º;91984633;ACERTE ADMINISTRADORA DE CONSÓRCIOS LTDA.;Descumprimento de prazo de resposta a demanda;0;1;0;1;
2019;2º;91984633;ACERTE ADMINISTRADORA DE CONSÓRCIOS LTDA.;Insatisfação com a resposta fornecida pela administradora de consórcio relativa à demanda registrada contra ela;0;1;0;1;
2019;2º;91984633;ACERTE ADMINISTRADORA DE CONSÓRCIOS LTDA.;Insatisfação por parte do cliente com o atendimento prestado pela administradora de consórcio;0;0;1;1;
2019;2º;91984633;ACERTE ADMINISTRADORA DE CONSÓRCIOS LTDA.;Não fornecimento, remessa ou divulgação de documentos obrigatórios;0;1;0;1;
2019;2º;91984633;ACERTE ADMINISTRADORA DE CONSÓRCIOS LTDA.;Outras irregularidades;2;6;0;8;
2019;2º;91984633;ACERTE ADMINISTRADORA DE CONSÓRCIOS LTDA.;Outras irregularidades relacionadas à Ouvidoria;0;1;0;1;
2019;2º;91984633;ACERTE ADMINISTRADORA DE CONSÓRCIOS LTDA.;Prestação inadequada/insuficiente de informação;0;0;2;2;
2019;2º;91984633;ACERTE ADMINISTRADORA DE CONSÓRCIOS LTDA.;Publicidade enganosa;0;0;4;4;
2019;2º;91984633;ACERTE ADMINISTRADORA DE CONSÓRCIOS LTDA.;Recusa ou demora no fornecimento de documentos (exceto demonstrativos obrigatórios);0;0;1;1;
2019;2º;84911098;ADEMILAR ADMINISTRADORA DE CONSORCIOS S.A.;Irregularidades relacionadas às condições para contemplação por lance ou sorteio;0;1;0;1;
2019;2º;84911098;ADEMILAR ADMINISTRADORA DE CONSORCIOS S.A.;Prestação inadequada/insuficiente de informação;0;0;1;1;
2019;2º;06044551;ADMINISTRADORA DE CONSORCIO NACIONAL GAZIN LTDA;Reclamações relacionadas a assuntos diversos;0;0;1;1;
2019;2º;45441789;ADMINISTRADORA DE CONSORCIO NACIONAL HONDA LTDA;Descumprimento de cláusulas referentes à devolução de valores;5;14;0;19;
2019;2º;45441789;ADMINISTRADORA DE CONSORCIO NACIONAL HONDA LTDA;Descumprimento de obrigações previstas em contratos;5;1;0;6;
2019;2º;45441789;ADMINISTRADORA DE CONSORCIO NACIONAL HONDA LTDA;Descumprimento de prazo de resposta a demanda;3;0;0;3;
2019;2º;45441789;ADMINISTRADORA DE CONSORCIO NACIONAL HONDA LTDA;Dificuldade na liberação ou substituição de bem;0;0;1;1;
2019;2º;45441789;ADMINISTRADORA DE CONSORCIO NACIONAL HONDA LTDA;Insatisfação com a resposta fornecida pela administradora de consórcio relativa à demanda registrada contra ela;0;1;0;1;
2019;2º;45441789;ADMINISTRADORA DE CONSORCIO NACIONAL HONDA LTDA;Insatisfação por parte do cliente com o atendimento prestado pela administradora de consórcio;0;0;10;10;
2019;2º;45441789;ADMINISTRADORA DE CONSORCIO NACIONAL HONDA LTDA;Irregularidades relacionadas à liberação do crédito;12;17;0;29;
2019;2º;45441789;ADMINISTRADORA DE CONSORCIO NACIONAL HONDA LTDA;Irregularidades relacionadas às condições para contemplação por lance ou sorteio;2;1;0;3;
2019;2º;45441789;ADMINISTRADORA DE CONSORCIO NACIONAL HONDA LTDA;Outras irregularidades;2;2;0;4;
2019;2º;45441789;ADMINISTRADORA DE CONSORCIO NACIONAL HONDA LTDA;Outras irregularidades relacionadas à Ouvidoria;1;0;0;1;
2019;2º;45441789;ADMINISTRADORA DE CONSORCIO NACIONAL HONDA LTDA;Prestação inadequada/insuficiente de informação;0;0;6;6;
2019;2º;45441789;ADMINISTRADORA DE CONSORCIO NACIONAL HONDA LTDA;Reclamações relacionadas a assuntos diversos;0;0;22;22;
2019;2º;45441789;ADMINISTRADORA DE CONSORCIO NACIONAL HONDA LTDA;Recusa ou demora no fornecimento de documentos (exceto demonstrativos obrigatórios);0;0;9;9;
2019;2º;07808907;ADMINISTRADORA DE CONSORCIOS SICREDI LTDA;Descumprimento de cláusulas referentes à devolução de valores;0;2;0;2;
2019;2º;07808907;ADMINISTRADORA DE CONSORCIOS SICREDI LTDA;Recusa ou demora no fornecimento de documentos (exceto demonstrativos obrigatórios);0;0;1;1;
2019;2º;31728579;ADMINISTRADORA DE CONSÓRCIO ECONÔMICO LTDA.;Descumprimento de cláusulas referentes à devolução de valores;1;0;0;1;
2019;2º;31728579;ADMINISTRADORA DE CONSÓRCIO ECONÔMICO LTDA.;Descumprimento de prazo de resposta a demanda;1;0;0;1;
2019;2º;31728579;ADMINISTRADORA DE CONSÓRCIO ECONÔMICO LTDA.;Prestação inadequada/insuficiente de informação;0;0;1;1;
2019;2º;73230674;ADMINISTRADORA DE CONSÓRCIO RCI BRASIL LTDA;Ausência de transparência nas relações contratuais;0;0;1;1;
2019;2º;73230674;ADMINISTRADORA DE CONSÓRCIO RCI BRASIL LTDA;Descumprimento de cláusulas referentes à devolução de valores;0;2;0;2;
2019;2º;73230674;ADMINISTRADORA DE CONSÓRCIO RCI BRASIL LTDA;Descumprimento de obrigações previstas em contratos;0;2;0;2;
2019;2º;73230674;ADMINISTRADORA DE CONSÓRCIO RCI BRASIL LTDA;Insatisfação com a resposta fornecida pela administradora de consórcio relativa à demanda registrada contra ela;0;1;0;1;
2019;2º;73230674;ADMINISTRADORA DE CONSÓRCIO RCI BRASIL LTDA;Insatisfação por parte do cliente com o atendimento prestado pela administradora de consórcio;0;0;1;1;
2019;2º;73230674;ADMINISTRADORA DE CONSÓRCIO RCI BRASIL LTDA;Irregularidades relacionadas à liberação do crédito;0;1;0;1;
2019;2º;73230674;ADMINISTRADORA DE CONSÓRCIO RCI BRASIL LTDA;Irregularidades relacionadas às condições para contemplação por lance ou sorteio;0;2;0;2;
2019;2º;73230674;ADMINISTRADORA DE CONSÓRCIO RCI BRASIL LTDA;Prestação inadequada/insuficiente de informação;0;0;1;1;
2019;2º;73230674;ADMINISTRADORA DE CONSÓRCIO RCI BRASIL LTDA;Publicidade enganosa;0;0;1;1;
2019;2º;03765340;ADMINISTRADORA DE CONSÓRCIO REGIONAL WAY LTDA.;Insatisfação com a resposta fornecida pela administradora de consórcio relativa à demanda registrada contra ela;0;1;0;1;
2019;2º;03765340;ADMINISTRADORA DE CONSÓRCIO REGIONAL WAY LTDA.;Outras irregularidades;1;8;0;9;
2019;2º;03765340;ADMINISTRADORA DE CONSÓRCIO REGIONAL WAY LTDA.;Prestação inadequada/insuficiente de informação;0;0;1;1;
2019;2º;03765340;ADMINISTRADORA DE CONSÓRCIO REGIONAL WAY LTDA.;Publicidade enganosa;0;0;4;4;
2019;2º;91341925;ADMINISTRADORA DE CONSÓRCIO SPENGLER LTDA.;Reclamações relacionadas a assuntos diversos;0;0;1;1;
2019;2º;12228808;ADMINISTRADORA DE CONSÓRCIO UNICOOB LTDA;Insatisfação com a resposta fornecida pela administradora de consórcio relativa à demanda registrada contra ela;0;1;0;1;
2019;2º;12228808;ADMINISTRADORA DE CONSÓRCIO UNICOOB LTDA;Irregularidades relacionadas à liberação do crédito;0;2;0;2;
2019;2º;12228808;ADMINISTRADORA DE CONSÓRCIO UNICOOB LTDA;Prestação inadequada/insuficiente de informação;0;0;2;2;
2019;2º;94187879;AGIBANK ADMINISTRADORA DE CONSÓRCIOS LTDA;Descumprimento de cláusulas referentes à devolução de valores;1;0;0;1;
2019;2º;94187879;AGIBANK ADMINISTRADORA DE CONSÓRCIOS LTDA;Prestação inadequada/insuficiente de informação;0;0;1;1;
2019;2º;60375243;ANCORA ADMINISTRADORA DE CONSORCIOS S.A.;Ausência de transparência nas relações contratuais;0;0;1;1;
2019;2º;60375243;ANCORA ADMINISTRADORA DE CONSORCIOS S.A.;Descumprimento de cláusulas referentes à devolução de valores;0;1;0;1;
2019;2º;60375243;ANCORA ADMINISTRADORA DE CONSORCIOS S.A.;Outras irregularidades;1;2;0;3;
2019;2º;60375243;ANCORA ADMINISTRADORA DE CONSORCIOS S.A.;Prestação inadequada/insuficiente de informação;0;0;1;1;
2019;2º;60375243;ANCORA ADMINISTRADORA DE CONSORCIOS S.A.;Publicidade enganosa;0;0;2;2;
2019;2º;71045363;BAMAQ ADMINISTRADORA DE CONSÓRCIOS LTDA;Descumprimento de cláusulas referentes à devolução de valores;0;2;0;2;
2019;2º;71045363;BAMAQ ADMINISTRADORA DE CONSÓRCIOS LTDA;Descumprimento de prazo de resposta a demanda;0;1;0;1;
2019;2º;71045363;BAMAQ ADMINISTRADORA DE CONSÓRCIOS LTDA;Irregularidades relacionadas à liberação do crédito;0;5;0;5;
2019;2º;71045363;BAMAQ ADMINISTRADORA DE CONSÓRCIOS LTDA;Irregularidades relacionadas às condições para contemplação por lance ou sorteio;0;1;0;1;
2019;2º;71045363;BAMAQ ADMINISTRADORA DE CONSÓRCIOS LTDA;Reclamações relacionadas a assuntos diversos;0;0;1;1;
2019;2º;02010478;BANCORBRÁS ADMINISTRADORA DE CONSÓRCIOS S.A.;Descumprimento de cláusulas referentes à devolução de valores;0;1;0;1;
2019;2º;02010478;BANCORBRÁS ADMINISTRADORA DE CONSÓRCIOS S.A.;Insatisfação com a resposta fornecida pela administradora de consórcio relativa à demanda registrada contra ela;0;1;0;1;
2019;2º;02010478;BANCORBRÁS ADMINISTRADORA DE CONSÓRCIOS S.A.;Outras irregularidades;0;1;0;1;
2019;2º;02010478;BANCORBRÁS ADMINISTRADORA DE CONSÓRCIOS S.A.;Recusa ou demora no fornecimento de documentos (exceto demonstrativos obrigatórios);0;0;1;1;
2019;2º;92692979;BANRISUL S.A. - ADMINISTRADORA DE CONSÓRCIOS;Descumprimento de cláusulas referentes à devolução de valores;2;2;0;4;
2019;2º;92692979;BANRISUL S.A. - ADMINISTRADORA DE CONSÓRCIOS;Descumprimento de prazo de resposta a demanda;0;1;0;1;
2019;2º;92692979;BANRISUL S.A. - ADMINISTRADORA DE CONSÓRCIOS;Dificuldade na liberação ou substituição de bem;0;0;1;1;
2019;2º;92692979;BANRISUL S.A. - ADMINISTRADORA DE CONSÓRCIOS;Insatisfação por parte do cliente com o atendimento prestado pela administradora de consórcio;0;0;1;1;
2019;2º;92692979;BANRISUL S.A. - ADMINISTRADORA DE CONSÓRCIOS;Irregularidades relacionadas à liberação do crédito;0;1;0;1;
2019;2º;92692979;BANRISUL S.A. - ADMINISTRADORA DE CONSÓRCIOS;Outras irregularidades;0;1;0;1;
2019;2º;92692979;BANRISUL S.A. - ADMINISTRADORA DE CONSÓRCIOS;Prestação inadequada/insuficiente de informação;0;0;1;1;
2019;2º;92692979;BANRISUL S.A. - ADMINISTRADORA DE CONSÓRCIOS;Reclamações relacionadas a assuntos diversos;0;0;2;2;
2019;2º;06043050;BB ADMINISTRADORA DE CONSORCIOS S.A.;Ausência de informações/cláusulas obrigatórias em contrato;0;1;0;1;
2019;2º;06043050;BB ADMINISTRADORA DE CONSORCIOS S.A.;Ausência de transparência nas relações contratuais;0;0;5;5;
2019;2º;06043050;BB ADMINISTRADORA DE CONSORCIOS S.A.;Cobrança irregular de tarifa pela emissão de boletos, carnês e assemelhados;0;2;0;2;
2019;2º;06043050;BB ADMINISTRADORA DE CONSORCIOS S.A.;Descumprimento de cláusulas referentes à devolução de valores;0;12;0;12;
2019;2º;06043050;BB ADMINISTRADORA DE CONSORCIOS S.A.;Descumprimento de obrigações previstas em contratos;8;24;0;32;
2019;2º;06043050;BB ADMINISTRADORA DE CONSORCIOS S.A.;Descumprimento de prazo de resposta a demanda;1;1;0;2;
2019;2º;06043050;BB ADMINISTRADORA DE CONSORCIOS S.A.;Dificuldade na liberação ou substituição de bem;0;0;6;6;
2019;2º;06043050;BB ADMINISTRADORA DE CONSORCIOS S.A.;Insatisfação com a resposta fornecida pela administradora de consórcio relativa à demanda registrada contra ela;1;10;0;11;
2019;2º;06043050;BB ADMINISTRADORA DE CONSORCIOS S.A.;Insatisfação por parte do cliente com o atendimento prestado pela administradora de consórcio;0;0;10;10;
2019;2º;06043050;BB ADMINISTRADORA DE CONSORCIOS S.A.;Irregularidades relacionadas à liberação do crédito;3;11;0;14;
2019;2º;06043050;BB ADMINISTRADORA DE CONSORCIOS S.A.;Irregularidades relacionadas às condições para contemplação por lance ou sorteio;0;7;0;7;
2019;2º;06043050;BB ADMINISTRADORA DE CONSORCIOS S.A.;Não fornecimento, remessa ou divulgação de documentos obrigatórios;0;1;0;1;
2019;2º;06043050;BB ADMINISTRADORA DE CONSORCIOS S.A.;Outras irregularidades;0;1;0;1;
2019;2º;06043050;BB ADMINISTRADORA DE CONSORCIOS S.A.;Outras irregularidades relacionadas à Ouvidoria;0;1;0;1;
2019;2º;06043050;BB ADMINISTRADORA DE CONSORCIOS S.A.;Prestação inadequada/insuficiente de informação;0;0;21;21;
2019;2º;06043050;BB ADMINISTRADORA DE CONSORCIOS S.A.;Publicidade enganosa;0;0;1;1;
2019;2º;06043050;BB ADMINISTRADORA DE CONSORCIOS S.A.;Reclamações relacionadas a assuntos diversos;0;0;11;11;
2019;2º;06043050;BB ADMINISTRADORA DE CONSORCIOS S.A.;Recusa ou demora no fornecimento de documentos (exceto demonstrativos obrigatórios);0;0;9;9;
2019;2º;14723388;BR CONSÓRCIOS ADMINISTRADORA DE CONSÓRCIOS LTDA;Descumprimento de obrigações previstas em contratos;0;1;0;1;
2019;2º;14723388;BR CONSÓRCIOS ADMINISTRADORA DE CONSÓRCIOS LTDA;Insatisfação por parte do cliente com o atendimento prestado pela administradora de consórcio;0;0;1;1;
2019;2º;14723388;BR CONSÓRCIOS ADMINISTRADORA DE CONSÓRCIOS LTDA;Prestação inadequada/insuficiente de informação;0;0;1;1;
2019;2º;14723388;BR CONSÓRCIOS ADMINISTRADORA DE CONSÓRCIOS LTDA;Reclamações relacionadas a assuntos diversos;0;0;3;3;
2019;2º;14723388;BR CONSÓRCIOS ADMINISTRADORA DE CONSÓRCIOS LTDA;Recusa ou demora no fornecimento de documentos (exceto demonstrativos obrigatórios);0;0;1;1;
2019;2º;52568821;BRADESCO ADMINISTRADORA DE CONSÓRCIOS LTDA.;Ausência de informações/cláusulas obrigatórias em contrato;2;0;0;2;
2019;2º;52568821;BRADESCO ADMINISTRADORA DE CONSÓRCIOS LTDA.;Ausência de transparência nas relações contratuais;0;0;17;17;
2019;2º;52568821;BRADESCO ADMINISTRADORA DE CONSÓRCIOS LTDA.;Cobrança irregular de tarifa pela emissão de boletos, carnês e assemelhados;0;1;0;1;
2019;2º;52568821;BRADESCO ADMINISTRADORA DE CONSÓRCIOS LTDA.;Descumprimento de cláusulas referentes à devolução de valores;5;64;0;69;
2019;2º;52568821;BRADESCO ADMINISTRADORA DE CONSÓRCIOS LTDA.;Descumprimento de obrigações previstas em contratos;11;83;0;94;
2019;2º;52568821;BRADESCO ADMINISTRADORA DE CONSÓRCIOS LTDA.;Descumprimento de prazo de resposta a demanda;1;7;0;8;
2019;2º;52568821;BRADESCO ADMINISTRADORA DE CONSÓRCIOS LTDA.;Dificuldade na liberação ou substituição de bem;0;0;68;68;
2019;2º;52568821;BRADESCO ADMINISTRADORA DE CONSÓRCIOS LTDA.;Golpe;0;0;1;1;
2019;2º;52568821;BRADESCO ADMINISTRADORA DE CONSÓRCIOS LTDA.;Insatisfação com a resposta fornecida pela administradora de consórcio relativa à demanda registrada contra ela;0;36;0;36;
2019;2º;52568821;BRADESCO ADMINISTRADORA DE CONSÓRCIOS LTDA.;Insatisfação por parte do cliente com o atendimento prestado pela administradora de consórcio;0;0;50;50;
2019;2º;52568821;BRADESCO ADMINISTRADORA DE CONSÓRCIOS LTDA.;Irregularidades relacionadas à liberação do crédito;2;114;0;116;
2019;2º;52568821;BRADESCO ADMINISTRADORA DE CONSÓRCIOS LTDA.;Irregularidades relacionadas às condições para contemplação por lance ou sorteio;1;14;0;15;
2019;2º;52568821;BRADESCO ADMINISTRADORA DE CONSÓRCIOS LTDA.;Outras irregularidades;1;8;0;9;
2019;2º;52568821;BRADESCO ADMINISTRADORA DE CONSÓRCIOS LTDA.;Prestação inadequada/insuficiente de informação;0;0;30;30;
2019;2º;52568821;BRADESCO ADMINISTRADORA DE CONSÓRCIOS LTDA.;Publicidade enganosa;0;0;2;2;
2019;2º;52568821;BRADESCO ADMINISTRADORA DE CONSÓRCIOS LTDA.;Reclamações relacionadas a assuntos diversos;0;0;34;34;
2019;2º;52568821;BRADESCO ADMINISTRADORA DE CONSÓRCIOS LTDA.;Recusa ou demora no fornecimento de documentos (exceto demonstrativos obrigatórios);0;0;52;52;
2019;2º;45713971;BRQUALY ADMINISTRADORA DE CONSÓRCIOS LTDA.;Descumprimento de cláusulas referentes à devolução de valores;1;0;0;1;
2019;2º;05349595;CAIXA CONSÓRCIOS S.A ADMINISTRADORA DE CONSÓRCIOS;Ausência de transparência nas relações contratuais;0;0;8;8;
2019;2º;05349595;CAIXA CONSÓRCIOS S.A ADMINISTRADORA DE CONSÓRCIOS;Descumprimento de cláusulas referentes à devolução de valores;3;26;0;29;
2019;2º;05349595;CAIXA CONSÓRCIOS S.A ADMINISTRADORA DE CONSÓRCIOS;Descumprimento de obrigações previstas em contratos;9;13;0;22;
2019;2º;05349595;CAIXA CONSÓRCIOS S.A ADMINISTRADORA DE CONSÓRCIOS;Descumprimento de prazo de resposta a demanda;1;2;0;3;
2019;2º;05349595;CAIXA CONSÓRCIOS S.A ADMINISTRADORA DE CONSÓRCIOS;Dificuldade na liberação ou substituição de bem;0;0;8;8;
2019;2º;05349595;CAIXA CONSÓRCIOS S.A ADMINISTRADORA DE CONSÓRCIOS;Golpe;0;0;1;1;
2019;2º;05349595;CAIXA CONSÓRCIOS S.A ADMINISTRADORA DE CONSÓRCIOS;Insatisfação com a resposta fornecida pela administradora de consórcio relativa à demanda registrada contra ela;3;8;0;11;
2019;2º;05349595;CAIXA CONSÓRCIOS S.A ADMINISTRADORA DE CONSÓRCIOS;Insatisfação por parte do cliente com o atendimento prestado pela administradora de consórcio;0;0;32;32;
2019;2º;05349595;CAIXA CONSÓRCIOS S.A ADMINISTRADORA DE CONSÓRCIOS;Irregularidades relacionadas à liberação do crédito;11;66;0;77;
2019;2º;05349595;CAIXA CONSÓRCIOS S.A ADMINISTRADORA DE CONSÓRCIOS;Irregularidades relacionadas às condições para contemplação por lance ou sorteio;0;3;0;3;
2019;2º;05349595;CAIXA CONSÓRCIOS S.A ADMINISTRADORA DE CONSÓRCIOS;Não fornecimento, remessa ou divulgação de documentos obrigatórios;0;2;0;2;
2019;2º;05349595;CAIXA CONSÓRCIOS S.A ADMINISTRADORA DE CONSÓRCIOS;Outras irregularidades;0;4;0;4;
2019;2º;05349595;CAIXA CONSÓRCIOS S.A ADMINISTRADORA DE CONSÓRCIOS;Prestação inadequada/insuficiente de informação;0;0;9;9;
2019;2º;05349595;CAIXA CONSÓRCIOS S.A ADMINISTRADORA DE CONSÓRCIOS;Publicidade enganosa;0;0;2;2;
2019;2º;05349595;CAIXA CONSÓRCIOS S.A ADMINISTRADORA DE CONSÓRCIOS;Reclamações relacionadas a assuntos diversos;0;0;23;23;
2019;2º;05349595;CAIXA CONSÓRCIOS S.A ADMINISTRADORA DE CONSÓRCIOS;Recusa ou demora no fornecimento de documentos (exceto demonstrativos obrigatórios);0;0;22;22;
2019;2º;68318773;CANOPUS ADMINISTRADORA DE CONSORCIOS S/A;Descumprimento de cláusulas referentes à devolução de valores;0;2;0;2;
2019;2º;68318773;CANOPUS ADMINISTRADORA DE CONSORCIOS S/A;Outras irregularidades;0;1;0;1;
2019;2º;68318773;CANOPUS ADMINISTRADORA DE CONSORCIOS S/A;Prestação inadequada/insuficiente de informação;0;0;1;1;
2019;2º;68318773;CANOPUS ADMINISTRADORA DE CONSORCIOS S/A;Recusa ou demora no fornecimento de documentos (exceto demonstrativos obrigatórios);0;0;1;1;
2019;2º;59129403;CNF - ADMINISTRADORA DE CONSÓRCIOS NACIONAL LTDA.;Ausência de transparência nas relações contratuais;0;0;1;1;
2019;2º;59129403;CNF - ADMINISTRADORA DE CONSÓRCIOS NACIONAL LTDA.;Descumprimento de cláusulas referentes à devolução de valores;2;0;0;2;
2019;2º;59129403;CNF - ADMINISTRADORA DE CONSÓRCIOS NACIONAL LTDA.;Descumprimento de obrigações previstas em contratos;1;0;0;1;
2019;2º;59129403;CNF - ADMINISTRADORA DE CONSÓRCIOS NACIONAL LTDA.;Dificuldade na liberação ou substituição de bem;0;0;1;1;
2019;2º;59129403;CNF - ADMINISTRADORA DE CONSÓRCIOS NACIONAL LTDA.;Prestação inadequada/insuficiente de informação;0;0;1;1;
2019;2º;59129403;CNF - ADMINISTRADORA DE CONSÓRCIOS NACIONAL LTDA.;Reclamações relacionadas a assuntos diversos;0;0;3;3;
2019;2º;44474674;COMAUTO ADMINISTRADORA DE CONSORCIO LTDA;Descumprimento de cláusulas referentes à devolução de valores;0;1;0;1;
2019;2º;44474674;COMAUTO ADMINISTRADORA DE CONSORCIO LTDA;Prestação inadequada/insuficiente de informação;0;0;1;1;
2019;2º;81742223;CONSEG ADMINISTRADORA DE CONSÓRCIOS S/A;Descumprimento de cláusulas referentes à devolução de valores;0;1;0;1;
2019;2º;81742223;CONSEG ADMINISTRADORA DE CONSÓRCIOS S/A;Outras irregularidades;0;1;0;1;
2019;2º;44196293;CONSHOP ADMINISTRADORA DE CONSORCIOS LTDA.;Descumprimento de obrigações previstas em contratos;1;0;0;1;
2019;2º;44196293;CONSHOP ADMINISTRADORA DE CONSORCIOS LTDA.;Descumprimento de prazo de resposta a demanda;1;0;0;1;
2019;2º;44196293;CONSHOP ADMINISTRADORA DE CONSORCIOS LTDA.;Prestação inadequada/insuficiente de informação;0;0;1;1;
2019;2º;44196293;CONSHOP ADMINISTRADORA DE CONSORCIOS LTDA.;Recusa ou demora no fornecimento de documentos (exceto demonstrativos obrigatórios);0;0;1;1;
2019;2º;47658539;CONSÓRCIO NACIONAL VOLKSWAGEN - ADMINISTRADORA DE CONSÓRCIO LTDA.;Ausência de transparência nas relações contratuais;0;0;1;1;
2019;2º;47658539;CONSÓRCIO NACIONAL VOLKSWAGEN - ADMINISTRADORA DE CONSÓRCIO LTDA.;Descumprimento de cláusulas referentes à devolução de valores;3;15;0;18;
2019;2º;47658539;CONSÓRCIO NACIONAL VOLKSWAGEN - ADMINISTRADORA DE CONSÓRCIO LTDA.;Descumprimento de obrigações previstas em contratos;2;5;0;7;
2019;2º;47658539;CONSÓRCIO NACIONAL VOLKSWAGEN - ADMINISTRADORA DE CONSÓRCIO LTDA.;Descumprimento de prazo de resposta a demanda;5;1;0;6;
2019;2º;47658539;CONSÓRCIO NACIONAL VOLKSWAGEN - ADMINISTRADORA DE CONSÓRCIO LTDA.;Dificuldade na liberação ou substituição de bem;0;0;11;11;
2019;2º;47658539;CONSÓRCIO NACIONAL VOLKSWAGEN - ADMINISTRADORA DE CONSÓRCIO LTDA.;Insatisfação com a resposta fornecida pela administradora de consórcio relativa à demanda registrada contra ela;2;15;0;17;
2019;2º;47658539;CONSÓRCIO NACIONAL VOLKSWAGEN - ADMINISTRADORA DE CONSÓRCIO LTDA.;Insatisfação por parte do cliente com o atendimento prestado pela administradora de consórcio;0;0;13;13;
2019;2º;47658539;CONSÓRCIO NACIONAL VOLKSWAGEN - ADMINISTRADORA DE CONSÓRCIO LTDA.;Irregularidades relacionadas à liberação do crédito;47;61;0;108;
2019;2º;47658539;CONSÓRCIO NACIONAL VOLKSWAGEN - ADMINISTRADORA DE CONSÓRCIO LTDA.;Irregularidades relacionadas às condições para contemplação por lance ou sorteio;1;1;0;2;
2019;2º;47658539;CONSÓRCIO NACIONAL VOLKSWAGEN - ADMINISTRADORA DE CONSÓRCIO LTDA.;Não fornecimento, remessa ou divulgação de documentos obrigatórios;0;1;0;1;
2019;2º;47658539;CONSÓRCIO NACIONAL VOLKSWAGEN - ADMINISTRADORA DE CONSÓRCIO LTDA.;Outras irregularidades;1;0;0;1;
2019;2º;47658539;CONSÓRCIO NACIONAL VOLKSWAGEN - ADMINISTRADORA DE CONSÓRCIO LTDA.;Outras irregularidades relacionadas à Ouvidoria;0;1;0;1;
2019;2º;47658539;CONSÓRCIO NACIONAL VOLKSWAGEN - ADMINISTRADORA DE CONSÓRCIO LTDA.;Prestação inadequada/insuficiente de informação;0;0;6;6;
2019;2º;47658539;CONSÓRCIO NACIONAL VOLKSWAGEN - ADMINISTRADORA DE CONSÓRCIO LTDA.;Reclamações relacionadas a assuntos diversos;0;0;22;22;
2019;2º;47658539;CONSÓRCIO NACIONAL VOLKSWAGEN - ADMINISTRADORA DE CONSÓRCIO LTDA.;Recusa ou demora no fornecimento de documentos (exceto demonstrativos obrigatórios);0;0;9;9;
2019;2º;58919903;CONVEF ADMINISTRADORA DE CONSÓRCIOS LTDA.;Insatisfação com a resposta fornecida pela administradora de consórcio relativa à demanda registrada contra ela;0;1;0;1;
2019;2º;58919903;CONVEF ADMINISTRADORA DE CONSÓRCIOS LTDA.;Irregularidades relacionadas à liberação do crédito;1;2;0;3;
2019;2º;58919903;CONVEF ADMINISTRADORA DE CONSÓRCIOS LTDA.;Irregularidades relacionadas às condições para contemplação por lance ou sorteio;0;4;0;4;
2019;2º;58919903;CONVEF ADMINISTRADORA DE CONSÓRCIOS LTDA.;Não fornecimento, remessa ou divulgação de documentos obrigatórios;0;1;0;1;
2019;2º;58919903;CONVEF ADMINISTRADORA DE CONSÓRCIOS LTDA.;Prestação inadequada/insuficiente de informação;0;0;2;2;
2019;2º;58919903;CONVEF ADMINISTRADORA DE CONSÓRCIOS LTDA.;Recusa ou demora no fornecimento de documentos (exceto demonstrativos obrigatórios);0;0;2;2;
2019;2º;61550836;COOPERATIVA MISTA JOCKEY CLUB DE SAO PAULO;Ausência de transparência nas relações contratuais;0;0;2;2;
2019;2º;61550836;COOPERATIVA MISTA JOCKEY CLUB DE SAO PAULO;Descumprimento de cláusulas referentes à devolução de valores;0;5;0;5;
2019;2º;61550836;COOPERATIVA MISTA JOCKEY CLUB DE SAO PAULO;Insatisfação com a resposta fornecida pela administradora de consórcio relativa à demanda registrada contra ela;1;1;0;2;
2019;2º;61550836;COOPERATIVA MISTA JOCKEY CLUB DE SAO PAULO;Irregularidades relacionadas à liberação do crédito;0;1;0;1;
2019;2º;61550836;COOPERATIVA MISTA JOCKEY CLUB DE SAO PAULO;Outras irregularidades;1;10;0;11;
2019;2º;61550836;COOPERATIVA MISTA JOCKEY CLUB DE SAO PAULO;Prestação inadequada/insuficiente de informação;0;0;2;2;
2019;2º;61550836;COOPERATIVA MISTA JOCKEY CLUB DE SAO PAULO;Publicidade enganosa;0;0;7;7;
2019;2º;59395061;DISAL ADMINISTRADORA DE CONSÓRCIOS LTDA;Ausência de transparência nas relações contratuais;0;0;2;2;
2019;2º;59395061;DISAL ADMINISTRADORA DE CONSÓRCIOS LTDA;Descumprimento de cláusulas referentes à devolução de valores;0;17;0;17;
2019;2º;59395061;DISAL ADMINISTRADORA DE CONSÓRCIOS LTDA;Descumprimento de obrigações previstas em contratos;0;8;0;8;
2019;2º;59395061;DISAL ADMINISTRADORA DE CONSÓRCIOS LTDA;Dificuldade na liberação ou substituição de bem;0;0;5;5;
2019;2º;59395061;DISAL ADMINISTRADORA DE CONSÓRCIOS LTDA;Insatisfação por parte do cliente com o atendimento prestado pela administradora de consórcio;0;0;3;3;
2019;2º;59395061;DISAL ADMINISTRADORA DE CONSÓRCIOS LTDA;Irregularidades relacionadas à liberação do crédito;1;19;0;20;
2019;2º;59395061;DISAL ADMINISTRADORA DE CONSÓRCIOS LTDA;Irregularidades relacionadas às condições para contemplação por lance ou sorteio;0;1;0;1;
2019;2º;59395061;DISAL ADMINISTRADORA DE CONSÓRCIOS LTDA;Outras irregularidades;0;1;0;1;
2019;2º;59395061;DISAL ADMINISTRADORA DE CONSÓRCIOS LTDA;Outras irregularidades relacionadas à Ouvidoria;1;0;0;1;
2019;2º;59395061;DISAL ADMINISTRADORA DE CONSÓRCIOS LTDA;Prestação inadequada/insuficiente de informação;0;0;1;1;
2019;2º;59395061;DISAL ADMINISTRADORA DE CONSÓRCIOS LTDA;Publicidade enganosa;0;0;2;2;
2019;2º;08570707;ELDORADO ADMINISTRADORA DE CONSORCIO LTDA;Outras irregularidades;1;0;0;1;
2019;2º;58113812;EMBRACON ADMINISTRADORA DE CONSÓRCIO LTDA;Ausência de transparência nas relações contratuais;0;0;8;8;
2019;2º;58113812;EMBRACON ADMINISTRADORA DE CONSÓRCIO LTDA;Cobrança irregular de tarifa pela emissão de boletos, carnês e assemelhados;0;1;0;1;
2019;2º;58113812;EMBRACON ADMINISTRADORA DE CONSÓRCIO LTDA;Descumprimento de cláusulas referentes à devolução de valores;1;16;0;17;
2019;2º;58113812;EMBRACON ADMINISTRADORA DE CONSÓRCIO LTDA;Descumprimento de obrigações previstas em contratos;1;9;0;10;
2019;2º;58113812;EMBRACON ADMINISTRADORA DE CONSÓRCIO LTDA;Dificuldade na liberação ou substituição de bem;0;0;1;1;
2019;2º;58113812;EMBRACON ADMINISTRADORA DE CONSÓRCIO LTDA;Insatisfação com a resposta fornecida pela administradora de consórcio relativa à demanda registrada contra ela;0;9;0;9;
2019;2º;58113812;EMBRACON ADMINISTRADORA DE CONSÓRCIO LTDA;Insatisfação por parte do cliente com o atendimento prestado pela administradora de consórcio;0;0;4;4;
2019;2º;58113812;EMBRACON ADMINISTRADORA DE CONSÓRCIO LTDA;Irregularidades relacionadas à liberação do crédito;0;30;0;30;
2019;2º;58113812;EMBRACON ADMINISTRADORA DE CONSÓRCIO LTDA;Irregularidades relacionadas às condições para contemplação por lance ou sorteio;0;10;0;10;
2019;2º;58113812;EMBRACON ADMINISTRADORA DE CONSÓRCIO LTDA;Não fornecimento, remessa ou divulgação de documentos obrigatórios;0;1;0;1;
2019;2º;58113812;EMBRACON ADMINISTRADORA DE CONSÓRCIO LTDA;Outras irregularidades;0;2;0;2;
2019;2º;58113812;EMBRACON ADMINISTRADORA DE CONSÓRCIO LTDA;Prestação inadequada/insuficiente de informação;0;0;6;6;
2019;2º;58113812;EMBRACON ADMINISTRADORA DE CONSÓRCIO LTDA;Publicidade enganosa;0;0;8;8;
2019;2º;58113812;EMBRACON ADMINISTRADORA DE CONSÓRCIO LTDA;Reclamações relacionadas a assuntos diversos;0;0;6;6;
2019;2º;58113812;EMBRACON ADMINISTRADORA DE CONSÓRCIO LTDA;Recusa ou demora no fornecimento de documentos (exceto demonstrativos obrigatórios);0;0;2;2;
2019;2º;91107581;FARROUPILHA ADMINISTRADORA DE CONSÓRCIOS LTDA.;Irregularidades relacionadas à liberação do crédito;0;1;0;1;
2019;2º;91107581;FARROUPILHA ADMINISTRADORA DE CONSÓRCIOS LTDA.;Reclamações relacionadas a assuntos diversos;0;0;1;1;
2019;2º;45725975;FINAMA ADMINISTRADORA DE CONSORCIO LTDA;Irregularidades relacionadas à liberação do crédito;0;1;0;1;
2019;2º;04751943;FRANCAUTO ADMINISTRADORA DE CONSÓRCIO LTDA.;Prestação inadequada/insuficiente de informação;0;0;1;1;
2019;2º;00643742;FUNDACAO HABITACIONAL DO EXERCITO - FHE;Insatisfação com a resposta fornecida pela administradora de consórcio relativa à demanda registrada contra ela;0;1;0;1;
2019;2º;00643742;FUNDACAO HABITACIONAL DO EXERCITO - FHE;Insatisfação por parte do cliente com o atendimento prestado pela administradora de consórcio;0;0;1;1;
2019;2º;00643742;FUNDACAO HABITACIONAL DO EXERCITO - FHE;Reclamações relacionadas a assuntos diversos;0;0;2;2;
2019;2º;85322204;GLOBO ADMINISTRADORA DE CONSÓRCIOS LTDA.;Irregularidades relacionadas às condições para contemplação por lance ou sorteio;0;1;0;1;
2019;2º;85322204;GLOBO ADMINISTRADORA DE CONSÓRCIOS LTDA.;Reclamações relacionadas a assuntos diversos;0;0;1;1;
2019;2º;49937055;GMAC ADMINISTRADORA DE CONSORCIOS LTDA;Cobrança irregular de tarifa pela emissão de boletos, carnês e assemelhados;0;1;0;1;
2019;2º;49937055;GMAC ADMINISTRADORA DE CONSORCIOS LTDA;Descumprimento de cláusulas referentes à devolução de valores;15;16;0;31;
2019;2º;49937055;GMAC ADMINISTRADORA DE CONSORCIOS LTDA;Descumprimento de obrigações previstas em contratos;3;2;0;5;
2019;2º;49937055;GMAC ADMINISTRADORA DE CONSORCIOS LTDA;Descumprimento de prazo de resposta a demanda;1;2;0;3;
2019;2º;49937055;GMAC ADMINISTRADORA DE CONSORCIOS LTDA;Dificuldade na liberação ou substituição de bem;0;0;17;17;
2019;2º;49937055;GMAC ADMINISTRADORA DE CONSORCIOS LTDA;Insatisfação com a resposta fornecida pela administradora de consórcio relativa à demanda registrada contra ela;1;5;0;6;
2019;2º;49937055;GMAC ADMINISTRADORA DE CONSORCIOS LTDA;Insatisfação por parte do cliente com o atendimento prestado pela administradora de consórcio;0;0;4;4;
2019;2º;49937055;GMAC ADMINISTRADORA DE CONSORCIOS LTDA;Irregularidades relacionadas à liberação do crédito;4;32;0;36;
2019;2º;49937055;GMAC ADMINISTRADORA DE CONSORCIOS LTDA;Outras irregularidades;7;1;0;8;
2019;2º;49937055;GMAC ADMINISTRADORA DE CONSORCIOS LTDA;Prestação inadequada/insuficiente de informação;0;0;4;4;
2019;2º;49937055;GMAC ADMINISTRADORA DE CONSORCIOS LTDA;Reclamações relacionadas a assuntos diversos;0;0;14;14;
2019;2º;49937055;GMAC ADMINISTRADORA DE CONSORCIOS LTDA;Recusa ou demora no fornecimento de documentos (exceto demonstrativos obrigatórios);0;0;3;3;
2019;2º;02798858;GOVESA ADMINISTRADORA DE CONSÓRCIOS LTDA;Descumprimento de cláusulas referentes à devolução de valores;0;3;0;3;
2019;2º;02798858;GOVESA ADMINISTRADORA DE CONSÓRCIOS LTDA;Descumprimento de obrigações previstas em contratos;1;2;0;3;
2019;2º;02798858;GOVESA ADMINISTRADORA DE CONSÓRCIOS LTDA;Insatisfação com a resposta fornecida pela administradora de consórcio relativa à demanda registrada contra ela;1;0;0;1;
2019;2º;02798858;GOVESA ADMINISTRADORA DE CONSÓRCIOS LTDA;Irregularidades relacionadas à liberação do crédito;0;1;0;1;
2019;2º;02798858;GOVESA ADMINISTRADORA DE CONSÓRCIOS LTDA;Outras irregularidades;0;6;0;6;
2019;2º;02798858;GOVESA ADMINISTRADORA DE CONSÓRCIOS LTDA;Prestação inadequada/insuficiente de informação;0;0;2;2;
2019;2º;02798858;GOVESA ADMINISTRADORA DE CONSÓRCIOS LTDA;Reclamações relacionadas a assuntos diversos;0;0;3;3;
2019;2º;26228270;GROSCON ADMINISTRADORA DE CONSORCIOS LTDA.;Descumprimento de cláusulas referentes à devolução de valores;0;1;0;1;
2019;2º;26228270;GROSCON ADMINISTRADORA DE CONSORCIOS LTDA.;Insatisfação com a resposta fornecida pela administradora de consórcio relativa à demanda registrada contra ela;1;0;0;1;
2019;2º;26228270;GROSCON ADMINISTRADORA DE CONSORCIOS LTDA.;Insatisfação por parte do cliente com o atendimento prestado pela administradora de consórcio;0;0;1;1;
2019;2º;26228270;GROSCON ADMINISTRADORA DE CONSORCIOS LTDA.;Outras irregularidades;1;1;0;2;
2019;2º;26228270;GROSCON ADMINISTRADORA DE CONSORCIOS LTDA.;Prestação inadequada/insuficiente de informação;0;0;1;1;
2019;2º;26253658;GUARAPIRANGA VEÍCULOS ADMINISTRADORA DE CONSÓRCIOS LTDA.;Reclamações relacionadas a assuntos diversos;0;0;1;1;
2019;2º;73516106;HS ADMINISTRADORA DE CONSÓRCIOS LTDA;Ausência de transparência nas relações contratuais;0;0;1;1;
2019;2º;73516106;HS ADMINISTRADORA DE CONSÓRCIOS LTDA;Irregularidades relacionadas à liberação do crédito;0;1;0;1;
2019;2º;73516106;HS ADMINISTRADORA DE CONSÓRCIOS LTDA;Outras irregularidades;0;1;0;1;
2019;2º;73516106;HS ADMINISTRADORA DE CONSÓRCIOS LTDA;Prestação inadequada/insuficiente de informação;0;0;1;1;
2019;2º;73516106;HS ADMINISTRADORA DE CONSÓRCIOS LTDA;Reclamações relacionadas a assuntos diversos;0;0;1;1;
2019;2º;06181431;ITAUNA ADMINISTRADORA DE CONSORCIO LTDA;Descumprimento de cláusulas referentes à devolução de valores;0;1;0;1;
2019;2º;06181431;ITAUNA ADMINISTRADORA DE CONSORCIO LTDA;Irregularidades relacionadas à liberação do crédito;0;3;0;3;
2019;2º;06181431;ITAUNA ADMINISTRADORA DE CONSORCIO LTDA;Reclamações relacionadas a assuntos diversos;0;0;1;1;
2019;2º;00000776;ITAÚ ADMINISTRADORA DE CONSÓRCIOS LTDA.;Ausência de informações/cláusulas obrigatórias em contrato;0;1;0;1;
2019;2º;00000776;ITAÚ ADMINISTRADORA DE CONSÓRCIOS LTDA.;Ausência de transparência nas relações contratuais;0;0;2;2;
2019;2º;00000776;ITAÚ ADMINISTRADORA DE CONSÓRCIOS LTDA.;Descumprimento de cláusulas referentes à devolução de valores;2;43;0;45;
2019;2º;00000776;ITAÚ ADMINISTRADORA DE CONSÓRCIOS LTDA.;Descumprimento de obrigações previstas em contratos;9;36;0;45;
2019;2º;00000776;ITAÚ ADMINISTRADORA DE CONSÓRCIOS LTDA.;Descumprimento de prazo de resposta a demanda;2;1;0;3;
2019;2º;00000776;ITAÚ ADMINISTRADORA DE CONSÓRCIOS LTDA.;Dificuldade na liberação ou substituição de bem;0;0;10;10;
2019;2º;00000776;ITAÚ ADMINISTRADORA DE CONSÓRCIOS LTDA.;Insatisfação com a resposta fornecida pela administradora de consórcio relativa à demanda registrada contra ela;0;5;0;5;
2019;2º;00000776;ITAÚ ADMINISTRADORA DE CONSÓRCIOS LTDA.;Insatisfação por parte do cliente com o atendimento prestado pela administradora de consórcio;0;0;27;27;
2019;2º;00000776;ITAÚ ADMINISTRADORA DE CONSÓRCIOS LTDA.;Irregularidades relacionadas à liberação do crédito;1;57;0;58;
2019;2º;00000776;ITAÚ ADMINISTRADORA DE CONSÓRCIOS LTDA.;Irregularidades relacionadas às condições para contemplação por lance ou sorteio;0;7;0;7;
2019;2º;00000776;ITAÚ ADMINISTRADORA DE CONSÓRCIOS LTDA.;Outras irregularidades;0;1;0;1;
2019;2º;00000776;ITAÚ ADMINISTRADORA DE CONSÓRCIOS LTDA.;Outras irregularidades relacionadas à Ouvidoria;0;2;0;2;
2019;2º;00000776;ITAÚ ADMINISTRADORA DE CONSÓRCIOS LTDA.;Prestação inadequada/insuficiente de informação;0;0;13;13;
2019;2º;00000776;ITAÚ ADMINISTRADORA DE CONSÓRCIOS LTDA.;Publicidade enganosa;0;0;1;1;
2019;2º;00000776;ITAÚ ADMINISTRADORA DE CONSÓRCIOS LTDA.;Reclamações relacionadas a assuntos diversos;0;0;13;13;
2019;2º;00000776;ITAÚ ADMINISTRADORA DE CONSÓRCIOS LTDA.;Recusa ou demora no fornecimento de documentos (exceto demonstrativos obrigatórios);0;0;16;16;
2019;2º;42421776;ITAÚ UNIBANCO VEÍCULOS ADMINISTRADORA DE CONSÓRCIOS LTDA.;Ausência de transparência nas relações contratuais;0;0;1;1;
2019;2º;42421776;ITAÚ UNIBANCO VEÍCULOS ADMINISTRADORA DE CONSÓRCIOS LTDA.;Cobrança irregular de tarifa pela emissão de boletos, carnês e assemelhados;0;1;0;1;
2019;2º;42421776;ITAÚ UNIBANCO VEÍCULOS ADMINISTRADORA DE CONSÓRCIOS LTDA.;Descumprimento de cláusulas referentes à devolução de valores;0;11;0;11;
2019;2º;42421776;ITAÚ UNIBANCO VEÍCULOS ADMINISTRADORA DE CONSÓRCIOS LTDA.;Descumprimento de obrigações previstas em contratos;0;1;0;1;
2019;2º;42421776;ITAÚ UNIBANCO VEÍCULOS ADMINISTRADORA DE CONSÓRCIOS LTDA.;Dificuldade na liberação ou substituição de bem;0;0;3;3;
2019;2º;42421776;ITAÚ UNIBANCO VEÍCULOS ADMINISTRADORA DE CONSÓRCIOS LTDA.;Insatisfação com a resposta fornecida pela administradora de consórcio relativa à demanda registrada contra ela;0;2;0;2;
2019;2º;42421776;ITAÚ UNIBANCO VEÍCULOS ADMINISTRADORA DE CONSÓRCIOS LTDA.;Insatisfação por parte do cliente com o atendimento prestado pela administradora de consórcio;0;0;2;2;
2019;2º;42421776;ITAÚ UNIBANCO VEÍCULOS ADMINISTRADORA DE CONSÓRCIOS LTDA.;Irregularidades relacionadas à liberação do crédito;0;8;0;8;
2019;2º;42421776;ITAÚ UNIBANCO VEÍCULOS ADMINISTRADORA DE CONSÓRCIOS LTDA.;Irregularidades relacionadas às condições para contemplação por lance ou sorteio;0;1;0;1;
2019;2º;42421776;ITAÚ UNIBANCO VEÍCULOS ADMINISTRADORA DE CONSÓRCIOS LTDA.;Prestação inadequada/insuficiente de informação;0;0;3;3;
2019;2º;42421776;ITAÚ UNIBANCO VEÍCULOS ADMINISTRADORA DE CONSÓRCIOS LTDA.;Reclamações relacionadas a assuntos diversos;0;0;1;1;
2019;2º;60250776;LUIZA ADMINISTRADORA DE CONSÓRCIOS LTDA;Descumprimento de cláusulas referentes à devolução de valores;0;5;0;5;
2019;2º;60250776;LUIZA ADMINISTRADORA DE CONSÓRCIOS LTDA;Descumprimento de obrigações previstas em contratos;0;1;0;1;
2019;2º;60250776;LUIZA ADMINISTRADORA DE CONSÓRCIOS LTDA;Irregularidades relacionadas à liberação do crédito;2;3;0;5;
2019;2º;60250776;LUIZA ADMINISTRADORA DE CONSÓRCIOS LTDA;Outras irregularidades;1;0;0;1;
2019;2º;60250776;LUIZA ADMINISTRADORA DE CONSÓRCIOS LTDA;Prestação inadequada/insuficiente de informação;0;0;2;2;
2019;2º;60250776;LUIZA ADMINISTRADORA DE CONSÓRCIOS LTDA;Reclamações relacionadas a assuntos diversos;0;0;1;1;
2019;2º;04250224;MAGGI ADMINISTRADORA DE CONSÓRCIOS LTDA;Dificuldade na liberação ou substituição de bem;0;0;2;2;
2019;2º;46349106;MERCABENCO MERCANTIL E ADMINISTRADORA DE BENS E CONSÓRCIOS LTDA.;Descumprimento de cláusulas referentes à devolução de valores;0;2;0;2;
2019;2º;05126027;MOTOASA ADMINISTRADORA DE CONSÓRCIOS LTDA.;Prestação inadequada/insuficiente de informação;0;0;1;1;
2019;2º;04124922;MULTIMARCAS ADMINISTRADORA DE CONSORCIOS LTDA.;Descumprimento de cláusulas referentes à devolução de valores;0;6;0;6;
2019;2º;04124922;MULTIMARCAS ADMINISTRADORA DE CONSORCIOS LTDA.;Descumprimento de obrigações previstas em contratos;0;1;0;1;
2019;2º;04124922;MULTIMARCAS ADMINISTRADORA DE CONSORCIOS LTDA.;Insatisfação com a resposta fornecida pela administradora de consórcio relativa à demanda registrada contra ela;0;4;0;4;
2019;2º;04124922;MULTIMARCAS ADMINISTRADORA DE CONSORCIOS LTDA.;Irregularidades relacionadas à liberação do crédito;0;4;0;4;
2019;2º;04124922;MULTIMARCAS ADMINISTRADORA DE CONSORCIOS LTDA.;Outras irregularidades;14;26;0;40;
2019;2º;04124922;MULTIMARCAS ADMINISTRADORA DE CONSORCIOS LTDA.;Publicidade enganosa;0;0;1;1;
2019;2º;04124922;MULTIMARCAS ADMINISTRADORA DE CONSORCIOS LTDA.;Reclamações relacionadas a assuntos diversos;0;0;4;4;
2019;2º;50533876;PAN ADMINISTRADORA DE CONSORCIO LTDA;Descumprimento de cláusulas referentes à devolução de valores;1;1;0;2;
2019;2º;50533876;PAN ADMINISTRADORA DE CONSORCIO LTDA;Descumprimento de obrigações previstas em contratos;0;1;0;1;
2019;2º;50533876;PAN ADMINISTRADORA DE CONSORCIO LTDA;Descumprimento de prazo de resposta a demanda;0;1;0;1;
2019;2º;50533876;PAN ADMINISTRADORA DE CONSORCIO LTDA;Insatisfação por parte do cliente com o atendimento prestado pela administradora de consórcio;0;0;3;3;
2019;2º;50533876;PAN ADMINISTRADORA DE CONSORCIO LTDA;Irregularidades relacionadas à liberação do crédito;2;2;0;4;
2019;2º;50533876;PAN ADMINISTRADORA DE CONSORCIO LTDA;Não fornecimento, remessa ou divulgação de documentos obrigatórios;0;1;0;1;
2019;2º;50533876;PAN ADMINISTRADORA DE CONSORCIO LTDA;Outras irregularidades;3;5;0;8;
2019;2º;50533876;PAN ADMINISTRADORA DE CONSORCIO LTDA;Prestação inadequada/insuficiente de informação;0;0;2;2;
2019;2º;50533876;PAN ADMINISTRADORA DE CONSORCIO LTDA;Publicidade enganosa;0;0;3;3;
2019;2º;50533876;PAN ADMINISTRADORA DE CONSORCIO LTDA;Reclamações relacionadas a assuntos diversos;0;0;1;1;
2019;2º;50533876;PAN ADMINISTRADORA DE CONSORCIO LTDA;Recusa ou demora no fornecimento de documentos (exceto demonstrativos obrigatórios);0;0;2;2;
2019;2º;16551061;PONTA ADMINISTRADORA DE CONSORCIOS LTDA;Ausência de transparência nas relações contratuais;0;0;2;2;
2019;2º;16551061;PONTA ADMINISTRADORA DE CONSORCIOS LTDA;Descumprimento de cláusulas referentes à devolução de valores;0;1;0;1;
2019;2º;16551061;PONTA ADMINISTRADORA DE CONSORCIOS LTDA;Insatisfação com a resposta fornecida pela administradora de consórcio relativa à demanda registrada contra ela;0;2;0;2;
2019;2º;16551061;PONTA ADMINISTRADORA DE CONSORCIOS LTDA;Insatisfação por parte do cliente com o atendimento prestado pela administradora de consórcio;0;0;2;2;
2019;2º;16551061;PONTA ADMINISTRADORA DE CONSORCIOS LTDA;Irregularidades relacionadas à liberação do crédito;0;5;0;5;
2019;2º;16551061;PONTA ADMINISTRADORA DE CONSORCIOS LTDA;Prestação inadequada/insuficiente de informação;0;0;1;1;
2019;2º;16551061;PONTA ADMINISTRADORA DE CONSORCIOS LTDA;Reclamações relacionadas a assuntos diversos;0;0;2;2;
2019;2º;16551061;PONTA ADMINISTRADORA DE CONSORCIOS LTDA;Recusa ou demora no fornecimento de documentos (exceto demonstrativos obrigatórios);0;0;3;3;
2019;2º;48041735;PORTO SEGURO ADMINISTRADORA DE CONSÓRCIOS LTDA;Ausência de transparência nas relações contratuais;0;0;2;2;
2019;2º;48041735;PORTO SEGURO ADMINISTRADORA DE CONSÓRCIOS LTDA;Cobrança irregular de tarifa pela emissão de boletos, carnês e assemelhados;0;1;0;1;
2019;2º;48041735;PORTO SEGURO ADMINISTRADORA DE CONSÓRCIOS LTDA;Descumprimento de cláusulas referentes à devolução de valores;0;9;0;9;
2019;2º;48041735;PORTO SEGURO ADMINISTRADORA DE CONSÓRCIOS LTDA;Descumprimento de obrigações previstas em contratos;2;7;0;9;
2019;2º;48041735;PORTO SEGURO ADMINISTRADORA DE CONSÓRCIOS LTDA;Dificuldade na liberação ou substituição de bem;0;0;2;2;
2019;2º;48041735;PORTO SEGURO ADMINISTRADORA DE CONSÓRCIOS LTDA;Insatisfação com a resposta fornecida pela administradora de consórcio relativa à demanda registrada contra ela;0;2;0;2;
2019;2º;48041735;PORTO SEGURO ADMINISTRADORA DE CONSÓRCIOS LTDA;Insatisfação por parte do cliente com o atendimento prestado pela administradora de consórcio;0;0;5;5;
2019;2º;48041735;PORTO SEGURO ADMINISTRADORA DE CONSÓRCIOS LTDA;Irregularidades relacionadas à liberação do crédito;0;6;0;6;
2019;2º;48041735;PORTO SEGURO ADMINISTRADORA DE CONSÓRCIOS LTDA;Irregularidades relacionadas às condições para contemplação por lance ou sorteio;1;5;0;6;
2019;2º;48041735;PORTO SEGURO ADMINISTRADORA DE CONSÓRCIOS LTDA;Outras irregularidades;0;2;0;2;
2019;2º;48041735;PORTO SEGURO ADMINISTRADORA DE CONSÓRCIOS LTDA;Prestação inadequada/insuficiente de informação;0;0;2;2;
2019;2º;48041735;PORTO SEGURO ADMINISTRADORA DE CONSÓRCIOS LTDA;Publicidade enganosa;0;0;1;1;
2019;2º;48041735;PORTO SEGURO ADMINISTRADORA DE CONSÓRCIOS LTDA;Reclamações relacionadas a assuntos diversos;0;0;4;4;
2019;2º;48041735;PORTO SEGURO ADMINISTRADORA DE CONSÓRCIOS LTDA;Recusa ou demora no fornecimento de documentos (exceto demonstrativos obrigatórios);0;0;2;2;
2019;2º;87433413;PORTOBENS ADMINISTRADORA DE CONSORCIOS LTDA;Irregularidades relacionadas à liberação do crédito;0;1;0;1;
2019;2º;87433413;PORTOBENS ADMINISTRADORA DE CONSORCIOS LTDA;Prestação inadequada/insuficiente de informação;0;0;1;1;
2019;2º;51597300;PRIMO ROSSI ADMINISTRADORA DE CONSÓRCIO LTDA.;Descumprimento de cláusulas referentes à devolução de valores;1;0;0;1;
2019;2º;51597300;PRIMO ROSSI ADMINISTRADORA DE CONSÓRCIO LTDA.;Dificuldade na liberação ou substituição de bem;0;0;1;1;
2019;2º;51597300;PRIMO ROSSI ADMINISTRADORA DE CONSÓRCIO LTDA.;Insatisfação com a resposta fornecida pela administradora de consórcio relativa à demanda registrada contra ela;0;1;0;1;
2019;2º;51597300;PRIMO ROSSI ADMINISTRADORA DE CONSÓRCIO LTDA.;Irregularidades relacionadas à liberação do crédito;0;1;0;1;
2019;2º;51597300;PRIMO ROSSI ADMINISTRADORA DE CONSÓRCIO LTDA.;Outras irregularidades;0;1;0;1;
2019;2º;51597300;PRIMO ROSSI ADMINISTRADORA DE CONSÓRCIO LTDA.;Prestação inadequada/insuficiente de informação;0;0;2;2;
2019;2º;91108027;RANDON ADMINISTRADORA DE CONSÓRCIOS LTDA.;Descumprimento de cláusulas referentes à devolução de valores;0;2;0;2;
2019;2º;91108027;RANDON ADMINISTRADORA DE CONSÓRCIOS LTDA.;Insatisfação com a resposta fornecida pela administradora de consórcio relativa à demanda registrada contra ela;0;2;0;2;
2019;2º;91108027;RANDON ADMINISTRADORA DE CONSÓRCIOS LTDA.;Irregularidades relacionadas à liberação do crédito;0;2;0;2;
2019;2º;91108027;RANDON ADMINISTRADORA DE CONSÓRCIOS LTDA.;Irregularidades relacionadas às condições para contemplação por lance ou sorteio;0;1;0;1;
2019;2º;91108027;RANDON ADMINISTRADORA DE CONSÓRCIOS LTDA.;Prestação inadequada/insuficiente de informação;0;0;1;1;
2019;2º;91108027;RANDON ADMINISTRADORA DE CONSÓRCIOS LTDA.;Reclamações relacionadas a assuntos diversos;0;0;2;2;
2019;2º;66228966;REALIZA ADMINISTRADORA DE CONSÓRCIOS LTDA.;Ausência de transparência nas relações contratuais;0;0;2;2;
2019;2º;66228966;REALIZA ADMINISTRADORA DE CONSÓRCIOS LTDA.;Descumprimento de cláusulas referentes à devolução de valores;1;3;0;4;
2019;2º;66228966;REALIZA ADMINISTRADORA DE CONSÓRCIOS LTDA.;Descumprimento de prazo de resposta a demanda;1;0;0;1;
2019;2º;66228966;REALIZA ADMINISTRADORA DE CONSÓRCIOS LTDA.;Prestação inadequada/insuficiente de informação;0;0;2;2;
2019;2º;66228966;REALIZA ADMINISTRADORA DE CONSÓRCIOS LTDA.;Reclamações relacionadas a assuntos diversos;0;0;1;1;
2019;2º;23767155;RECON ADMINISTRADORA DE CONSORCIOS LTDA;Cobrança irregular de tarifa pela emissão de boletos, carnês e assemelhados;0;1;0;1;
2019;2º;23767155;RECON ADMINISTRADORA DE CONSORCIOS LTDA;Descumprimento de obrigações previstas em contratos;1;1;0;2;
2019;2º;23767155;RECON ADMINISTRADORA DE CONSORCIOS LTDA;Irregularidades relacionadas às condições para contemplação por lance ou sorteio;0;1;0;1;
2019;2º;23767155;RECON ADMINISTRADORA DE CONSORCIOS LTDA;Prestação inadequada/insuficiente de informação;0;0;3;3;
2019;2º;23767155;RECON ADMINISTRADORA DE CONSORCIOS LTDA;Publicidade enganosa;0;0;1;1;
2019;2º;62354055;REMAZA ADMINISTRADORA DE CONSÓRCIO LTDA.;Ausência de transparência nas relações contratuais;0;0;1;1;
2019;2º;62354055;REMAZA ADMINISTRADORA DE CONSÓRCIO LTDA.;Cobrança irregular de tarifa pela emissão de boletos, carnês e assemelhados;0;2;0;2;
2019;2º;62354055;REMAZA ADMINISTRADORA DE CONSÓRCIO LTDA.;Descumprimento de cláusulas referentes à devolução de valores;0;6;0;6;
2019;2º;62354055;REMAZA ADMINISTRADORA DE CONSÓRCIO LTDA.;Descumprimento de obrigações previstas em contratos;0;2;0;2;
2019;2º;62354055;REMAZA ADMINISTRADORA DE CONSÓRCIO LTDA.;Insatisfação com a resposta fornecida pela administradora de consórcio relativa à demanda registrada contra ela;0;1;0;1;
2019;2º;62354055;REMAZA ADMINISTRADORA DE CONSÓRCIO LTDA.;Insatisfação por parte do cliente com o atendimento prestado pela administradora de consórcio;0;0;1;1;
2019;2º;62354055;REMAZA ADMINISTRADORA DE CONSÓRCIO LTDA.;Irregularidades relacionadas à liberação do crédito;0;2;0;2;
2019;2º;62354055;REMAZA ADMINISTRADORA DE CONSÓRCIO LTDA.;Irregularidades relacionadas às condições para contemplação por lance ou sorteio;0;4;0;4;
2019;2º;62354055;REMAZA ADMINISTRADORA DE CONSÓRCIO LTDA.;Outras irregularidades;0;3;0;3;
2019;2º;62354055;REMAZA ADMINISTRADORA DE CONSÓRCIO LTDA.;Prestação inadequada/insuficiente de informação;0;0;8;8;
2019;2º;62354055;REMAZA ADMINISTRADORA DE CONSÓRCIO LTDA.;Publicidade enganosa;0;0;6;6;
2019;2º;62354055;REMAZA ADMINISTRADORA DE CONSÓRCIO LTDA.;Reclamações relacionadas a assuntos diversos;0;0;5;5;
2019;2º;62354055;REMAZA ADMINISTRADORA DE CONSÓRCIO LTDA.;Recusa ou demora no fornecimento de documentos (exceto demonstrativos obrigatórios);0;0;2;2;
2019;2º;28904092;RESERVA ADMINISTRADORA DE CONSÓRCIO LTDA;Outras irregularidades;1;0;0;1;
2019;2º;28904092;RESERVA ADMINISTRADORA DE CONSÓRCIO LTDA;Publicidade enganosa;0;0;2;2;
2019;2º;51855716;RODOBENS ADMINISTRADORA DE CONSÓRCIOS LTDA.;Ausência de informações/cláusulas obrigatórias em contrato;1;0;0;1;
2019;2º;51855716;RODOBENS ADMINISTRADORA DE CONSÓRCIOS LTDA.;Ausência de transparência nas relações contratuais;0;0;1;1;
2019;2º;51855716;RODOBENS ADMINISTRADORA DE CONSÓRCIOS LTDA.;Descumprimento de cláusulas referentes à devolução de valores;1;11;0;12;
2019;2º;51855716;RODOBENS ADMINISTRADORA DE CONSÓRCIOS LTDA.;Descumprimento de obrigações previstas em contratos;1;3;0;4;
2019;2º;51855716;RODOBENS ADMINISTRADORA DE CONSÓRCIOS LTDA.;Dificuldade na liberação ou substituição de bem;0;0;4;4;
2019;2º;51855716;RODOBENS ADMINISTRADORA DE CONSÓRCIOS LTDA.;Insatisfação com a resposta fornecida pela administradora de consórcio relativa à demanda registrada contra ela;0;5;0;5;
2019;2º;51855716;RODOBENS ADMINISTRADORA DE CONSÓRCIOS LTDA.;Insatisfação por parte do cliente com o atendimento prestado pela administradora de consórcio;0;0;4;4;
2019;2º;51855716;RODOBENS ADMINISTRADORA DE CONSÓRCIOS LTDA.;Irregularidades relacionadas à liberação do crédito;1;8;0;9;
2019;2º;51855716;RODOBENS ADMINISTRADORA DE CONSÓRCIOS LTDA.;Irregularidades relacionadas às condições para contemplação por lance ou sorteio;0;2;0;2;
2019;2º;51855716;RODOBENS ADMINISTRADORA DE CONSÓRCIOS LTDA.;Outras irregularidades;2;3;0;5;
2019;2º;51855716;RODOBENS ADMINISTRADORA DE CONSÓRCIOS LTDA.;Prestação inadequada/insuficiente de informação;0;0;2;2;
2019;2º;51855716;RODOBENS ADMINISTRADORA DE CONSÓRCIOS LTDA.;Reclamações relacionadas a assuntos diversos;0;0;9;9;
2019;2º;51855716;RODOBENS ADMINISTRADORA DE CONSÓRCIOS LTDA.;Recusa ou demora no fornecimento de documentos (exceto demonstrativos obrigatórios);0;0;3;3;
2019;2º;55942312;SANTANDER BRASIL ADMINISTRADORA DE CONSÓRCIO LTDA.;Ausência de transparência nas relações contratuais;0;0;1;1;
2019;2º;55942312;SANTANDER BRASIL ADMINISTRADORA DE CONSÓRCIO LTDA.;Cobrança irregular de tarifa pela emissão de boletos, carnês e assemelhados;0;1;0;1;
2019;2º;55942312;SANTANDER BRASIL ADMINISTRADORA DE CONSÓRCIO LTDA.;Descumprimento de cláusulas referentes à devolução de valores;4;5;0;9;
2019;2º;55942312;SANTANDER BRASIL ADMINISTRADORA DE CONSÓRCIO LTDA.;Descumprimento de obrigações previstas em contratos;2;5;0;7;
2019;2º;55942312;SANTANDER BRASIL ADMINISTRADORA DE CONSÓRCIO LTDA.;Dificuldade na liberação ou substituição de bem;0;0;2;2;
2019;2º;55942312;SANTANDER BRASIL ADMINISTRADORA DE CONSÓRCIO LTDA.;Insatisfação com a resposta fornecida pela administradora de consórcio relativa à demanda registrada contra ela;1;5;0;6;
2019;2º;55942312;SANTANDER BRASIL ADMINISTRADORA DE CONSÓRCIO LTDA.;Insatisfação por parte do cliente com o atendimento prestado pela administradora de consórcio;0;0;5;5;
2019;2º;55942312;SANTANDER BRASIL ADMINISTRADORA DE CONSÓRCIO LTDA.;Irregularidades relacionadas à liberação do crédito;2;44;0;46;
2019;2º;55942312;SANTANDER BRASIL ADMINISTRADORA DE CONSÓRCIO LTDA.;Irregularidades relacionadas às condições para contemplação por lance ou sorteio;0;5;0;5;
2019;2º;55942312;SANTANDER BRASIL ADMINISTRADORA DE CONSÓRCIO LTDA.;Não fornecimento, remessa ou divulgação de documentos obrigatórios;1;2;0;3;
2019;2º;55942312;SANTANDER BRASIL ADMINISTRADORA DE CONSÓRCIO LTDA.;Outras irregularidades;2;4;0;6;
2019;2º;55942312;SANTANDER BRASIL ADMINISTRADORA DE CONSÓRCIO LTDA.;Prestação inadequada/insuficiente de informação;0;0;7;7;
2019;2º;55942312;SANTANDER BRASIL ADMINISTRADORA DE CONSÓRCIO LTDA.;Reclamações relacionadas a assuntos diversos;0;0;26;26;
2019;2º;55942312;SANTANDER BRASIL ADMINISTRADORA DE CONSÓRCIO LTDA.;Recusa ou demora no fornecimento de documentos (exceto demonstrativos obrigatórios);0;0;3;3;
2019;2º;96479258;SCANIA ADMINISTRADORA DE CONSÓRCIOS LTDA.;Descumprimento de cláusulas referentes à devolução de valores;0;5;0;5;
2019;2º;96479258;SCANIA ADMINISTRADORA DE CONSÓRCIOS LTDA.;Reclamações relacionadas a assuntos diversos;0;0;1;1;
2019;2º;96479258;SCANIA ADMINISTRADORA DE CONSÓRCIOS LTDA.;Recusa ou demora no fornecimento de documentos (exceto demonstrativos obrigatórios);0;0;1;1;
2019;2º;76515071;SERVOPA ADMINISTRADORA DE CONSORCIOS LTDA;Descumprimento de cláusulas referentes à devolução de valores;0;1;0;1;
2019;2º;76515071;SERVOPA ADMINISTRADORA DE CONSORCIOS LTDA;Descumprimento de obrigações previstas em contratos;1;0;0;1;
2019;2º;76515071;SERVOPA ADMINISTRADORA DE CONSORCIOS LTDA;Não fornecimento, remessa ou divulgação de documentos obrigatórios;0;1;0;1;
2019;2º;76515071;SERVOPA ADMINISTRADORA DE CONSORCIOS LTDA;Reclamações relacionadas a assuntos diversos;0;0;1;1;
2019;2º;87852273;SINOSSERRA ADMINISTRADORA DE CONSÓRCIOS LTDA;Outras irregularidades;0;1;0;1;
2019;2º;87636635;SPONCHIADO ADMINISTRADORA DE CONSÓRCIOS LTDA.;Descumprimento de prazo de resposta a demanda;0;1;0;1;
2019;2º;57723801;SUZUKI MOTOS ADMINISTRADORA DE CONSÓRCIO LTDA.;Descumprimento de cláusulas referentes à devolução de valores;1;0;0;1;
2019;2º;57723801;SUZUKI MOTOS ADMINISTRADORA DE CONSÓRCIO LTDA.;Descumprimento de obrigações previstas em contratos;1;0;0;1;
2019;2º;53211488;TARRAF ADMINISTRADORA DE CONSÓRCIOS LTDA.;Irregularidades relacionadas à liberação do crédito;0;2;0;2;
2019;2º;59956185;TRADIÇÃO ADMINISTRADORA DE CONSÓRCIO LTDA.;Descumprimento de cláusulas referentes à devolução de valores;1;0;0;1;
2019;2º;59956185;TRADIÇÃO ADMINISTRADORA DE CONSÓRCIO LTDA.;Reclamações relacionadas a assuntos diversos;0;0;1;1;
2019;2º;83553883;UNIÃO CATARINENSE ADMINISTRADORA DE CONSORCIOS LTDA;Insatisfação com a resposta fornecida pela administradora de consórcio relativa à demanda registrada contra ela;1;0;0;1;
2019;2º;83553883;UNIÃO CATARINENSE ADMINISTRADORA DE CONSORCIOS LTDA;Não fornecimento, remessa ou divulgação de documentos obrigatórios;1;0;0;1;
2019;2º;83553883;UNIÃO CATARINENSE ADMINISTRADORA DE CONSORCIOS LTDA;Prestação inadequada/insuficiente de informação;0;0;1;1;
2019;2º;60732997;UNIFISA ADMINISTRADORA NACIONAL DE CONSORCIOS LTDA;Descumprimento de cláusulas referentes à devolução de valores;0;2;0;2;
2019;2º;60732997;UNIFISA ADMINISTRADORA NACIONAL DE CONSORCIOS LTDA;Insatisfação com a resposta fornecida pela administradora de consórcio relativa à demanda registrada contra ela;0;2;0;2;
2019;2º;60732997;UNIFISA ADMINISTRADORA NACIONAL DE CONSORCIOS LTDA;Irregularidades relacionadas à liberação do crédito;0;1;0;1;
2019;2º;60732997;UNIFISA ADMINISTRADORA NACIONAL DE CONSORCIOS LTDA;Irregularidades relacionadas às condições para contemplação por lance ou sorteio;0;1;0;1;
2019;2º;60732997;UNIFISA ADMINISTRADORA NACIONAL DE CONSORCIOS LTDA;Outras irregularidades;0;4;0;4;
2019;2º;60732997;UNIFISA ADMINISTRADORA NACIONAL DE CONSORCIOS LTDA;Prestação inadequada/insuficiente de informação;0;0;1;1;
2019;2º;60732997;UNIFISA ADMINISTRADORA NACIONAL DE CONSORCIOS LTDA;Reclamações relacionadas a assuntos diversos;0;0;2;2;
2019;2º;56360266;VALTRA ADMINISTRADORA DE CONSÓRCIOS LTDA;Prestação inadequada/insuficiente de informação;0;0;1;1;
2019;2º;49995293;VINAC ADMINISTRADORA DE CONSÓRCIOS LTDA.;Prestação inadequada/insuficiente de informação;0;0;1;1;
2019;2º;50827237;VKN ADMINISTRADORA DE CONSÓRCIO LTDA.;Prestação inadequada/insuficiente de informação;0;0;1;1;
2019;2º;74118381;VOLVO ADMINISTRADORA DE CONSÓRCIO LTDA.;Descumprimento de cláusulas referentes à devolução de valores;1;0;0;1;
2019;2º;74118381;VOLVO ADMINISTRADORA DE CONSÓRCIO LTDA.;Insatisfação por parte do cliente com o atendimento prestado pela administradora de consórcio;0;0;1;1;
2019;2º;74118381;VOLVO ADMINISTRADORA DE CONSÓRCIO LTDA.;Reclamações relacionadas a assuntos diversos;0;0;2;2;
2019;2º;74118381;VOLVO ADMINISTRADORA DE CONSÓRCIO LTDA.;Recusa ou demora no fornecimento de documentos (exceto demonstrativos obrigatórios);0;0;2;2;
2019;2º;47458153;YAMAHA ADMINISTRADORA DE CONSÓRCIO LTDA.;Dificuldade na liberação ou substituição de bem;0;0;3;3;
2019;2º;47458153;YAMAHA ADMINISTRADORA DE CONSÓRCIO LTDA.;Insatisfação com a resposta fornecida pela administradora de consórcio relativa à demanda registrada contra ela;0;1;0;1;
2019;2º;47458153;YAMAHA ADMINISTRADORA DE CONSÓRCIO LTDA.;Insatisfação por parte do cliente com o atendimento prestado pela administradora de consórcio;0;0;2;2;
2019;2º;47458153;YAMAHA ADMINISTRADORA DE CONSÓRCIO LTDA.;Irregularidades relacionadas à liberação do crédito;0;1;0;1;
2019;2º;47458153;YAMAHA ADMINISTRADORA DE CONSÓRCIO LTDA.;Prestação inadequada/insuficiente de informação;0;0;1;1;
2019;2º;47458153;YAMAHA ADMINISTRADORA DE CONSÓRCIO LTDA.;Reclamações relacionadas a assuntos diversos;0;0;4;4;
2019;2º;47458153;YAMAHA ADMINISTRADORA DE CONSÓRCIO LTDA.;Recusa ou demora no fornecimento de documentos (exceto demonstrativos obrigatórios);0;0;3;3;
2019;2º;23367634;ZEMA ADMINISTRADORA DE CONSÓRCIO LTDA;Descumprimento de cláusulas referentes à devolução de valores;0;2;0;2;
2019;2º;23367634;ZEMA ADMINISTRADORA DE CONSÓRCIO LTDA;Irregularidades relacionadas à liberação do crédito;0;6;0;6;
2019;2º;23367634;ZEMA ADMINISTRADORA DE CONSÓRCIO LTDA;Não fornecimento, remessa ou divulgação de documentos obrigatórios;0;1;0;1;
2019;2º;23367634;ZEMA ADMINISTRADORA DE CONSÓRCIO LTDA;Outras irregularidades;0;3;0;3;
2019;2º;23367634;ZEMA ADMINISTRADORA DE CONSÓRCIO LTDA;Publicidade enganosa;0;0;3;3;
2019;2º;23367634;ZEMA ADMINISTRADORA DE CONSÓRCIO LTDA;Recusa ou demora no fornecimento de documentos (exceto demonstrativos obrigatórios);0;0;2;2;
