Ano;Semestre;CNPJ AC;Administradora de consórcio;Irregularidade;Quantidade de reclamações reguladas procedentes;Quantidade de reclamações reguladas - outras;Quantidade de reclamações não reguladas;Quantidade total de reclamações;
2018;2º;91984633;ACERTE ADMINISTRADORA DE CONSÓRCIOS LTDA.;Descumprimento de cláusulas referentes à devolução de valores;0;1;0;1;
2018;2º;91984633;ACERTE ADMINISTRADORA DE CONSÓRCIOS LTDA.;Insatisfação com a resposta fornecida pela administradora de consórcio relativa à demanda registrada contra ela;0;1;0;1;
2018;2º;91984633;ACERTE ADMINISTRADORA DE CONSÓRCIOS LTDA.;Outras irregularidades;0;2;0;2;
2018;2º;91984633;ACERTE ADMINISTRADORA DE CONSÓRCIOS LTDA.;Prestação inadequada/insuficiente de informação;0;0;3;3;
2018;2º;91984633;ACERTE ADMINISTRADORA DE CONSÓRCIOS LTDA.;Publicidade enganosa;0;0;6;6;
2018;2º;84911098;ADEMILAR ADMINISTRADORA DE CONSORCIOS S.A.;Descumprimento de obrigações previstas em contratos;0;1;0;1;
2018;2º;84911098;ADEMILAR ADMINISTRADORA DE CONSORCIOS S.A.;Insatisfação por parte do cliente com o atendimento prestado pela administradora de consórcio;0;0;1;1;
2018;2º;84911098;ADEMILAR ADMINISTRADORA DE CONSORCIOS S.A.;Irregularidades relacionadas às condições para contemplação por lance ou sorteio;0;1;0;1;
2018;2º;84911098;ADEMILAR ADMINISTRADORA DE CONSORCIOS S.A.;Outras irregularidades;0;1;0;1;
2018;2º;84911098;ADEMILAR ADMINISTRADORA DE CONSORCIOS S.A.;Recusa ou demora no fornecimento de documentos (exceto demonstrativos obrigatórios);0;0;1;1;
2018;2º;06044551;ADMINISTRADORA DE CONSORCIO NACIONAL GAZIN LTDA;Ausência de transparência nas relações contratuais;0;0;1;1;
2018;2º;06044551;ADMINISTRADORA DE CONSORCIO NACIONAL GAZIN LTDA;Descumprimento de cláusulas referentes à devolução de valores;0;1;0;1;
2018;2º;06044551;ADMINISTRADORA DE CONSORCIO NACIONAL GAZIN LTDA;Insatisfação por parte do cliente com o atendimento prestado pela administradora de consórcio;0;0;1;1;
2018;2º;45441789;ADMINISTRADORA DE CONSORCIO NACIONAL HONDA LTDA;Ausência de transparência nas relações contratuais;0;0;8;8;
2018;2º;45441789;ADMINISTRADORA DE CONSORCIO NACIONAL HONDA LTDA;Descumprimento de cláusulas referentes à devolução de valores;1;24;0;25;
2018;2º;45441789;ADMINISTRADORA DE CONSORCIO NACIONAL HONDA LTDA;Descumprimento de obrigações previstas em contratos;1;1;0;2;
2018;2º;45441789;ADMINISTRADORA DE CONSORCIO NACIONAL HONDA LTDA;Descumprimento de prazo de resposta a demanda;1;2;0;3;
2018;2º;45441789;ADMINISTRADORA DE CONSORCIO NACIONAL HONDA LTDA;Dificuldade na liberação ou substituição de bem;0;0;4;4;
2018;2º;45441789;ADMINISTRADORA DE CONSORCIO NACIONAL HONDA LTDA;Insatisfação com a resposta fornecida pela administradora de consórcio relativa à demanda registrada contra ela;1;8;0;9;
2018;2º;45441789;ADMINISTRADORA DE CONSORCIO NACIONAL HONDA LTDA;Insatisfação por parte do cliente com o atendimento prestado pela administradora de consórcio;0;0;23;23;
2018;2º;45441789;ADMINISTRADORA DE CONSORCIO NACIONAL HONDA LTDA;Irregularidades relacionadas à liberação do crédito;3;35;0;38;
2018;2º;45441789;ADMINISTRADORA DE CONSORCIO NACIONAL HONDA LTDA;Irregularidades relacionadas às condições para contemplação por lance ou sorteio;0;1;0;1;
2018;2º;45441789;ADMINISTRADORA DE CONSORCIO NACIONAL HONDA LTDA;Prestação inadequada/insuficiente de informação;0;0;10;10;
2018;2º;45441789;ADMINISTRADORA DE CONSORCIO NACIONAL HONDA LTDA;Reclamações relacionadas a assuntos diversos;0;0;15;15;
2018;2º;45441789;ADMINISTRADORA DE CONSORCIO NACIONAL HONDA LTDA;Recusa ou demora no fornecimento de documentos (exceto demonstrativos obrigatórios);0;0;5;5;
2018;2º;07808907;ADMINISTRADORA DE CONSORCIOS SICREDI LTDA;Dificuldade na liberação ou substituição de bem;0;0;1;1;
2018;2º;07808907;ADMINISTRADORA DE CONSORCIOS SICREDI LTDA;Irregularidades relacionadas à liberação do crédito;0;2;0;2;
2018;2º;07808907;ADMINISTRADORA DE CONSORCIOS SICREDI LTDA;Reclamações relacionadas a assuntos diversos;0;0;1;1;
2018;2º;07808907;ADMINISTRADORA DE CONSORCIOS SICREDI LTDA;Recusa ou demora no fornecimento de documentos (exceto demonstrativos obrigatórios);0;0;1;1;
2018;2º;31728579;ADMINISTRADORA DE CONSÓRCIO ECONÔMICO LTDA.;Descumprimento de cláusulas referentes à devolução de valores;1;1;0;2;
2018;2º;31728579;ADMINISTRADORA DE CONSÓRCIO ECONÔMICO LTDA.;Descumprimento de prazo de resposta a demanda;1;0;0;1;
2018;2º;31728579;ADMINISTRADORA DE CONSÓRCIO ECONÔMICO LTDA.;Insatisfação por parte do cliente com o atendimento prestado pela administradora de consórcio;0;0;1;1;
2018;2º;30412977;ADMINISTRADORA DE CONSÓRCIO NACIONAL LÍDER LTDA.;Recusa ou demora no fornecimento de documentos (exceto demonstrativos obrigatórios);0;0;1;1;
2018;2º;73230674;ADMINISTRADORA DE CONSÓRCIO RCI BRASIL LTDA;Descumprimento de obrigações previstas em contratos;0;2;0;2;
2018;2º;73230674;ADMINISTRADORA DE CONSÓRCIO RCI BRASIL LTDA;Descumprimento de prazo de resposta a demanda;0;1;0;1;
2018;2º;73230674;ADMINISTRADORA DE CONSÓRCIO RCI BRASIL LTDA;Insatisfação por parte do cliente com o atendimento prestado pela administradora de consórcio;0;0;1;1;
2018;2º;73230674;ADMINISTRADORA DE CONSÓRCIO RCI BRASIL LTDA;Irregularidades relacionadas à liberação do crédito;0;2;0;2;
2018;2º;73230674;ADMINISTRADORA DE CONSÓRCIO RCI BRASIL LTDA;Prestação inadequada/insuficiente de informação;0;0;1;1;
2018;2º;73230674;ADMINISTRADORA DE CONSÓRCIO RCI BRASIL LTDA;Reclamações relacionadas a assuntos diversos;0;0;1;1;
2018;2º;03765340;ADMINISTRADORA DE CONSÓRCIO REGIONAL WAY LTDA.;Descumprimento de cláusulas referentes à devolução de valores;0;3;0;3;
2018;2º;03765340;ADMINISTRADORA DE CONSÓRCIO REGIONAL WAY LTDA.;Descumprimento de obrigações previstas em contratos;0;1;0;1;
2018;2º;03765340;ADMINISTRADORA DE CONSÓRCIO REGIONAL WAY LTDA.;Insatisfação com a resposta fornecida pela administradora de consórcio relativa à demanda registrada contra ela;0;1;0;1;
2018;2º;03765340;ADMINISTRADORA DE CONSÓRCIO REGIONAL WAY LTDA.;Irregularidades relacionadas às condições para contemplação por lance ou sorteio;0;1;0;1;
2018;2º;03765340;ADMINISTRADORA DE CONSÓRCIO REGIONAL WAY LTDA.;Outras irregularidades;2;11;0;13;
2018;2º;03765340;ADMINISTRADORA DE CONSÓRCIO REGIONAL WAY LTDA.;Prestação inadequada/insuficiente de informação;0;0;1;1;
2018;2º;03765340;ADMINISTRADORA DE CONSÓRCIO REGIONAL WAY LTDA.;Publicidade enganosa;0;0;19;19;
2018;2º;91341925;ADMINISTRADORA DE CONSÓRCIO SPENGLER LTDA.;Descumprimento de cláusulas referentes à devolução de valores;0;3;0;3;
2018;2º;91341925;ADMINISTRADORA DE CONSÓRCIO SPENGLER LTDA.;Insatisfação com a resposta fornecida pela administradora de consórcio relativa à demanda registrada contra ela;0;2;0;2;
2018;2º;12228808;ADMINISTRADORA DE CONSÓRCIO UNICOOB LTDA;Descumprimento de obrigações previstas em contratos;0;1;0;1;
2018;2º;12228808;ADMINISTRADORA DE CONSÓRCIO UNICOOB LTDA;Prestação inadequada/insuficiente de informação;0;0;1;1;
2018;2º;94187879;AGIBANK ADMINISTRADORA DE CONSÓRCIOS LTDA;Insatisfação com a resposta fornecida pela administradora de consórcio relativa à demanda registrada contra ela;0;1;0;1;
2018;2º;94187879;AGIBANK ADMINISTRADORA DE CONSÓRCIOS LTDA;Irregularidades relacionadas à liberação do crédito;0;1;0;1;
2018;2º;60375243;ANCORA ADMINISTRADORA DE CONSORCIOS S.A.;Ausência de transparência nas relações contratuais;0;0;1;1;
2018;2º;60375243;ANCORA ADMINISTRADORA DE CONSORCIOS S.A.;Prestação inadequada/insuficiente de informação;0;0;6;6;
2018;2º;21275235;ATUAL ADMINISTRADORA DE CONSÓRCIO LTDA.;Recusa ou demora no fornecimento de documentos (exceto demonstrativos obrigatórios);0;0;1;1;
2018;2º;71045363;BAMAQ ADMINISTRADORA DE CONSÓRCIOS LTDA;Ausência de transparência nas relações contratuais;0;0;1;1;
2018;2º;02010478;BANCORBRÁS ADMINISTRADORA DE CONSÓRCIOS S.A.;Descumprimento de cláusulas referentes à devolução de valores;0;2;0;2;
2018;2º;02010478;BANCORBRÁS ADMINISTRADORA DE CONSÓRCIOS S.A.;Insatisfação com a resposta fornecida pela administradora de consórcio relativa à demanda registrada contra ela;0;2;0;2;
2018;2º;02010478;BANCORBRÁS ADMINISTRADORA DE CONSÓRCIOS S.A.;Irregularidades relacionadas à liberação do crédito;0;2;0;2;
2018;2º;02010478;BANCORBRÁS ADMINISTRADORA DE CONSÓRCIOS S.A.;Outras irregularidades;0;1;0;1;
2018;2º;02010478;BANCORBRÁS ADMINISTRADORA DE CONSÓRCIOS S.A.;Prestação inadequada/insuficiente de informação;0;0;1;1;
2018;2º;02010478;BANCORBRÁS ADMINISTRADORA DE CONSÓRCIOS S.A.;Reclamações relacionadas a assuntos diversos;0;0;2;2;
2018;2º;92692979;BANRISUL S.A. - ADMINISTRADORA DE CONSÓRCIOS;Descumprimento de cláusulas referentes à devolução de valores;0;2;0;2;
2018;2º;92692979;BANRISUL S.A. - ADMINISTRADORA DE CONSÓRCIOS;Descumprimento de obrigações previstas em contratos;0;1;0;1;
2018;2º;92692979;BANRISUL S.A. - ADMINISTRADORA DE CONSÓRCIOS;Insatisfação por parte do cliente com o atendimento prestado pela administradora de consórcio;0;0;4;4;
2018;2º;92692979;BANRISUL S.A. - ADMINISTRADORA DE CONSÓRCIOS;Irregularidades relacionadas à liberação do crédito;0;2;0;2;
2018;2º;92692979;BANRISUL S.A. - ADMINISTRADORA DE CONSÓRCIOS;Irregularidades relacionadas às condições para contemplação por lance ou sorteio;0;1;0;1;
2018;2º;92692979;BANRISUL S.A. - ADMINISTRADORA DE CONSÓRCIOS;Outras irregularidades;0;1;0;1;
2018;2º;92692979;BANRISUL S.A. - ADMINISTRADORA DE CONSÓRCIOS;Reclamações relacionadas a assuntos diversos;0;0;1;1;
2018;2º;45030236;BAURU ADMINISTRADORA DE CONSÓRCIOS LTDA;Prestação inadequada/insuficiente de informação;0;0;1;1;
2018;2º;06043050;BB ADMINISTRADORA DE CONSORCIOS S.A.;Ausência de transparência nas relações contratuais;0;0;3;3;
2018;2º;06043050;BB ADMINISTRADORA DE CONSORCIOS S.A.;Descumprimento de cláusulas referentes à devolução de valores;2;13;0;15;
2018;2º;06043050;BB ADMINISTRADORA DE CONSORCIOS S.A.;Descumprimento de obrigações previstas em contratos;4;14;0;18;
2018;2º;06043050;BB ADMINISTRADORA DE CONSORCIOS S.A.;Descumprimento de prazo de resposta a demanda;0;2;0;2;
2018;2º;06043050;BB ADMINISTRADORA DE CONSORCIOS S.A.;Descumprimento de prazo para apresentação de resposta conclusiva pela Ouvidoria;0;1;0;1;
2018;2º;06043050;BB ADMINISTRADORA DE CONSORCIOS S.A.;Dificuldade na liberação ou substituição de bem;0;0;5;5;
2018;2º;06043050;BB ADMINISTRADORA DE CONSORCIOS S.A.;Insatisfação com a resposta fornecida pela administradora de consórcio relativa à demanda registrada contra ela;0;9;0;9;
2018;2º;06043050;BB ADMINISTRADORA DE CONSORCIOS S.A.;Insatisfação por parte do cliente com o atendimento prestado pela administradora de consórcio;0;0;8;8;
2018;2º;06043050;BB ADMINISTRADORA DE CONSORCIOS S.A.;Irregularidades relacionadas à liberação do crédito;5;14;0;19;
2018;2º;06043050;BB ADMINISTRADORA DE CONSORCIOS S.A.;Irregularidades relacionadas às condições para contemplação por lance ou sorteio;0;4;0;4;
2018;2º;06043050;BB ADMINISTRADORA DE CONSORCIOS S.A.;Não fornecimento, remessa ou divulgação de documentos obrigatórios;0;1;0;1;
2018;2º;06043050;BB ADMINISTRADORA DE CONSORCIOS S.A.;Prestação inadequada/insuficiente de informação;0;0;14;14;
2018;2º;06043050;BB ADMINISTRADORA DE CONSORCIOS S.A.;Publicidade enganosa;0;0;2;2;
2018;2º;06043050;BB ADMINISTRADORA DE CONSORCIOS S.A.;Reclamações relacionadas a assuntos diversos;0;0;10;10;
2018;2º;06043050;BB ADMINISTRADORA DE CONSORCIOS S.A.;Recusa ou demora no fornecimento de documentos (exceto demonstrativos obrigatórios);0;0;14;14;
2018;2º;14723388;BR CONSÓRCIOS ADMINISTRADORA DE CONSÓRCIOS LTDA;Ausência de transparência nas relações contratuais;0;0;1;1;
2018;2º;14723388;BR CONSÓRCIOS ADMINISTRADORA DE CONSÓRCIOS LTDA;Descumprimento de cláusulas referentes à devolução de valores;0;7;0;7;
2018;2º;14723388;BR CONSÓRCIOS ADMINISTRADORA DE CONSÓRCIOS LTDA;Descumprimento de obrigações previstas em contratos;0;1;0;1;
2018;2º;14723388;BR CONSÓRCIOS ADMINISTRADORA DE CONSÓRCIOS LTDA;Descumprimento de prazo de resposta a demanda;0;1;0;1;
2018;2º;14723388;BR CONSÓRCIOS ADMINISTRADORA DE CONSÓRCIOS LTDA;Dificuldade na liberação ou substituição de bem;0;0;2;2;
2018;2º;14723388;BR CONSÓRCIOS ADMINISTRADORA DE CONSÓRCIOS LTDA;Insatisfação com a resposta fornecida pela administradora de consórcio relativa à demanda registrada contra ela;0;4;0;4;
2018;2º;14723388;BR CONSÓRCIOS ADMINISTRADORA DE CONSÓRCIOS LTDA;Irregularidades relacionadas à liberação do crédito;0;1;0;1;
2018;2º;14723388;BR CONSÓRCIOS ADMINISTRADORA DE CONSÓRCIOS LTDA;Outras irregularidades;1;0;0;1;
2018;2º;14723388;BR CONSÓRCIOS ADMINISTRADORA DE CONSÓRCIOS LTDA;Prestação inadequada/insuficiente de informação;0;0;4;4;
2018;2º;14723388;BR CONSÓRCIOS ADMINISTRADORA DE CONSÓRCIOS LTDA;Recusa ou demora no fornecimento de documentos (exceto demonstrativos obrigatórios);0;0;3;3;
2018;2º;52568821;BRADESCO ADMINISTRADORA DE CONSÓRCIOS LTDA.;Ausência de informações/cláusulas obrigatórias em contrato;1;1;0;2;
2018;2º;52568821;BRADESCO ADMINISTRADORA DE CONSÓRCIOS LTDA.;Ausência de transparência nas relações contratuais;0;0;13;13;
2018;2º;52568821;BRADESCO ADMINISTRADORA DE CONSÓRCIOS LTDA.;Cobrança irregular de tarifa pela emissão de boletos, carnês e assemelhados;0;3;0;3;
2018;2º;52568821;BRADESCO ADMINISTRADORA DE CONSÓRCIOS LTDA.;Descumprimento de cláusulas referentes à devolução de valores;0;44;0;44;
2018;2º;52568821;BRADESCO ADMINISTRADORA DE CONSÓRCIOS LTDA.;Descumprimento de obrigações previstas em contratos;13;67;0;80;
2018;2º;52568821;BRADESCO ADMINISTRADORA DE CONSÓRCIOS LTDA.;Descumprimento de prazo de resposta a demanda;0;8;0;8;
2018;2º;52568821;BRADESCO ADMINISTRADORA DE CONSÓRCIOS LTDA.;Dificuldade na liberação ou substituição de bem;0;0;73;73;
2018;2º;52568821;BRADESCO ADMINISTRADORA DE CONSÓRCIOS LTDA.;Insatisfação com a resposta fornecida pela administradora de consórcio relativa à demanda registrada contra ela;3;36;0;39;
2018;2º;52568821;BRADESCO ADMINISTRADORA DE CONSÓRCIOS LTDA.;Insatisfação por parte do cliente com o atendimento prestado pela administradora de consórcio;0;0;93;93;
2018;2º;52568821;BRADESCO ADMINISTRADORA DE CONSÓRCIOS LTDA.;Irregularidades relacionadas à liberação do crédito;3;199;0;202;
2018;2º;52568821;BRADESCO ADMINISTRADORA DE CONSÓRCIOS LTDA.;Irregularidades relacionadas às condições para contemplação por lance ou sorteio;0;5;0;5;
2018;2º;52568821;BRADESCO ADMINISTRADORA DE CONSÓRCIOS LTDA.;Não fornecimento, remessa ou divulgação de documentos obrigatórios;0;4;0;4;
2018;2º;52568821;BRADESCO ADMINISTRADORA DE CONSÓRCIOS LTDA.;Operações de entidades não fiscalizadas pelo Banco Central;0;0;1;1;
2018;2º;52568821;BRADESCO ADMINISTRADORA DE CONSÓRCIOS LTDA.;Outras irregularidades;2;6;0;8;
2018;2º;52568821;BRADESCO ADMINISTRADORA DE CONSÓRCIOS LTDA.;Prestação inadequada/insuficiente de informação;0;0;54;54;
2018;2º;52568821;BRADESCO ADMINISTRADORA DE CONSÓRCIOS LTDA.;Publicidade enganosa;0;0;3;3;
2018;2º;52568821;BRADESCO ADMINISTRADORA DE CONSÓRCIOS LTDA.;Reclamações relacionadas a assuntos diversos;0;0;77;77;
2018;2º;52568821;BRADESCO ADMINISTRADORA DE CONSÓRCIOS LTDA.;Recusa ou demora no fornecimento de documentos (exceto demonstrativos obrigatórios);0;0;52;52;
2018;2º;03762395;BRENNER ADMINISTRADORA DE CONSORCIO LTDA;Reclamações relacionadas a assuntos diversos;0;0;1;1;
2018;2º;45713971;BRQUALY ADMINISTRADORA DE CONSÓRCIOS LTDA.;Reclamações relacionadas a assuntos diversos;0;0;1;1;
2018;2º;05349595;CAIXA CONSÓRCIOS S.A ADMINISTRADORA DE CONSÓRCIOS;Ausência de transparência nas relações contratuais;0;0;3;3;
2018;2º;05349595;CAIXA CONSÓRCIOS S.A ADMINISTRADORA DE CONSÓRCIOS;Cobrança irregular de tarifa pela emissão de boletos, carnês e assemelhados;0;1;0;1;
2018;2º;05349595;CAIXA CONSÓRCIOS S.A ADMINISTRADORA DE CONSÓRCIOS;Descumprimento de cláusulas referentes à devolução de valores;2;14;0;16;
2018;2º;05349595;CAIXA CONSÓRCIOS S.A ADMINISTRADORA DE CONSÓRCIOS;Descumprimento de obrigações previstas em contratos;3;14;0;17;
2018;2º;05349595;CAIXA CONSÓRCIOS S.A ADMINISTRADORA DE CONSÓRCIOS;Descumprimento de prazo de resposta a demanda;0;4;0;4;
2018;2º;05349595;CAIXA CONSÓRCIOS S.A ADMINISTRADORA DE CONSÓRCIOS;Dificuldade na liberação ou substituição de bem;0;0;5;5;
2018;2º;05349595;CAIXA CONSÓRCIOS S.A ADMINISTRADORA DE CONSÓRCIOS;Insatisfação com a resposta fornecida pela administradora de consórcio relativa à demanda registrada contra ela;0;10;0;10;
2018;2º;05349595;CAIXA CONSÓRCIOS S.A ADMINISTRADORA DE CONSÓRCIOS;Insatisfação por parte do cliente com o atendimento prestado pela administradora de consórcio;0;0;30;30;
2018;2º;05349595;CAIXA CONSÓRCIOS S.A ADMINISTRADORA DE CONSÓRCIOS;Irregularidades relacionadas à liberação do crédito;1;49;0;50;
2018;2º;05349595;CAIXA CONSÓRCIOS S.A ADMINISTRADORA DE CONSÓRCIOS;Irregularidades relacionadas às condições para contemplação por lance ou sorteio;0;2;0;2;
2018;2º;05349595;CAIXA CONSÓRCIOS S.A ADMINISTRADORA DE CONSÓRCIOS;Não fornecimento, remessa ou divulgação de documentos obrigatórios;0;1;0;1;
2018;2º;05349595;CAIXA CONSÓRCIOS S.A ADMINISTRADORA DE CONSÓRCIOS;Outras irregularidades;0;2;0;2;
2018;2º;05349595;CAIXA CONSÓRCIOS S.A ADMINISTRADORA DE CONSÓRCIOS;Prestação inadequada/insuficiente de informação;0;0;9;9;
2018;2º;05349595;CAIXA CONSÓRCIOS S.A ADMINISTRADORA DE CONSÓRCIOS;Publicidade enganosa;0;0;4;4;
2018;2º;05349595;CAIXA CONSÓRCIOS S.A ADMINISTRADORA DE CONSÓRCIOS;Reclamações relacionadas a assuntos diversos;0;0;23;23;
2018;2º;05349595;CAIXA CONSÓRCIOS S.A ADMINISTRADORA DE CONSÓRCIOS;Recusa ou demora no fornecimento de documentos (exceto demonstrativos obrigatórios);0;0;10;10;
2018;2º;68318773;CANOPUS ADMINISTRADORA DE CONSORCIOS S/A;Dificuldade na liberação ou substituição de bem;0;0;4;4;
2018;2º;68318773;CANOPUS ADMINISTRADORA DE CONSORCIOS S/A;Irregularidades relacionadas à liberação do crédito;0;1;0;1;
2018;2º;68318773;CANOPUS ADMINISTRADORA DE CONSORCIOS S/A;Irregularidades relacionadas às condições para contemplação por lance ou sorteio;0;1;0;1;
2018;2º;68318773;CANOPUS ADMINISTRADORA DE CONSORCIOS S/A;Outras irregularidades;0;5;0;5;
2018;2º;68318773;CANOPUS ADMINISTRADORA DE CONSORCIOS S/A;Reclamações relacionadas a assuntos diversos;0;0;2;2;
2018;2º;00266031;CICAL ADMINISTRADORA DE CONSÓRCIOS LTDA;Irregularidades relacionadas à liberação do crédito;0;1;0;1;
2018;2º;59129403;CNF - ADMINISTRADORA DE CONSÓRCIOS NACIONAL LTDA.;Ausência de transparência nas relações contratuais;0;0;1;1;
2018;2º;59129403;CNF - ADMINISTRADORA DE CONSÓRCIOS NACIONAL LTDA.;Descumprimento de cláusulas referentes à devolução de valores;0;3;0;3;
2018;2º;59129403;CNF - ADMINISTRADORA DE CONSÓRCIOS NACIONAL LTDA.;Dificuldade na liberação ou substituição de bem;0;0;1;1;
2018;2º;59129403;CNF - ADMINISTRADORA DE CONSÓRCIOS NACIONAL LTDA.;Insatisfação por parte do cliente com o atendimento prestado pela administradora de consórcio;0;0;2;2;
2018;2º;59129403;CNF - ADMINISTRADORA DE CONSÓRCIOS NACIONAL LTDA.;Irregularidades relacionadas à liberação do crédito;0;1;0;1;
2018;2º;59129403;CNF - ADMINISTRADORA DE CONSÓRCIOS NACIONAL LTDA.;Reclamações relacionadas a assuntos diversos;0;0;2;2;
2018;2º;62798475;CNK ADMINISTRADORA DE CONSÓRCIO LTDA.;Prestação inadequada/insuficiente de informação;0;0;1;1;
2018;2º;27268770;COIMEX ADMINISTRADORA DE CONSÓRCIOS LTDA.;Prestação inadequada/insuficiente de informação;0;0;1;1;
2018;2º;44474674;COMAUTO ADMINISTRADORA DE CONSORCIO LTDA;Prestação inadequada/insuficiente de informação;0;0;1;1;
2018;2º;44474674;COMAUTO ADMINISTRADORA DE CONSORCIO LTDA;Publicidade enganosa;0;0;1;1;
2018;2º;81742223;CONSEG ADMINISTRADORA DE CONSÓRCIOS S/A;Descumprimento de cláusulas referentes à devolução de valores;0;1;0;1;
2018;2º;81742223;CONSEG ADMINISTRADORA DE CONSÓRCIOS S/A;Prestação inadequada/insuficiente de informação;0;0;1;1;
2018;2º;44196293;CONSHOP ADMINISTRADORA DE CONSORCIOS LTDA.;Publicidade enganosa;0;0;1;1;
2018;2º;47658539;CONSÓRCIO NACIONAL VOLKSWAGEN - ADMINISTRADORA DE CONSÓRCIO LTDA.;Ausência de transparência nas relações contratuais;0;0;10;10;
2018;2º;47658539;CONSÓRCIO NACIONAL VOLKSWAGEN - ADMINISTRADORA DE CONSÓRCIO LTDA.;Descumprimento de cláusulas referentes à devolução de valores;3;22;0;25;
2018;2º;47658539;CONSÓRCIO NACIONAL VOLKSWAGEN - ADMINISTRADORA DE CONSÓRCIO LTDA.;Descumprimento de prazo de resposta a demanda;1;0;0;1;
2018;2º;47658539;CONSÓRCIO NACIONAL VOLKSWAGEN - ADMINISTRADORA DE CONSÓRCIO LTDA.;Dificuldade na liberação ou substituição de bem;0;0;7;7;
2018;2º;47658539;CONSÓRCIO NACIONAL VOLKSWAGEN - ADMINISTRADORA DE CONSÓRCIO LTDA.;Insatisfação com a resposta fornecida pela administradora de consórcio relativa à demanda registrada contra ela;0;9;0;9;
2018;2º;47658539;CONSÓRCIO NACIONAL VOLKSWAGEN - ADMINISTRADORA DE CONSÓRCIO LTDA.;Insatisfação por parte do cliente com o atendimento prestado pela administradora de consórcio;0;0;24;24;
2018;2º;47658539;CONSÓRCIO NACIONAL VOLKSWAGEN - ADMINISTRADORA DE CONSÓRCIO LTDA.;Irregularidades relacionadas à liberação do crédito;4;27;0;31;
2018;2º;47658539;CONSÓRCIO NACIONAL VOLKSWAGEN - ADMINISTRADORA DE CONSÓRCIO LTDA.;Irregularidades relacionadas às condições para contemplação por lance ou sorteio;0;4;0;4;
2018;2º;47658539;CONSÓRCIO NACIONAL VOLKSWAGEN - ADMINISTRADORA DE CONSÓRCIO LTDA.;Outras irregularidades;0;1;0;1;
2018;2º;47658539;CONSÓRCIO NACIONAL VOLKSWAGEN - ADMINISTRADORA DE CONSÓRCIO LTDA.;Prestação inadequada/insuficiente de informação;0;0;21;21;
2018;2º;47658539;CONSÓRCIO NACIONAL VOLKSWAGEN - ADMINISTRADORA DE CONSÓRCIO LTDA.;Reclamações relacionadas a assuntos diversos;0;0;19;19;
2018;2º;47658539;CONSÓRCIO NACIONAL VOLKSWAGEN - ADMINISTRADORA DE CONSÓRCIO LTDA.;Recusa ou demora no fornecimento de documentos (exceto demonstrativos obrigatórios);0;0;6;6;
2018;2º;58919903;CONVEF ADMINISTRADORA DE CONSÓRCIOS LTDA.;Ausência de transparência nas relações contratuais;0;0;1;1;
2018;2º;58919903;CONVEF ADMINISTRADORA DE CONSÓRCIOS LTDA.;Descumprimento de cláusulas referentes à devolução de valores;0;1;0;1;
2018;2º;58919903;CONVEF ADMINISTRADORA DE CONSÓRCIOS LTDA.;Descumprimento de obrigações previstas em contratos;0;2;0;2;
2018;2º;58919903;CONVEF ADMINISTRADORA DE CONSÓRCIOS LTDA.;Insatisfação por parte do cliente com o atendimento prestado pela administradora de consórcio;0;0;1;1;
2018;2º;58919903;CONVEF ADMINISTRADORA DE CONSÓRCIOS LTDA.;Irregularidades relacionadas à liberação do crédito;1;1;0;2;
2018;2º;58919903;CONVEF ADMINISTRADORA DE CONSÓRCIOS LTDA.;Prestação inadequada/insuficiente de informação;0;0;4;4;
2018;2º;58919903;CONVEF ADMINISTRADORA DE CONSÓRCIOS LTDA.;Publicidade enganosa;0;0;1;1;
2018;2º;58919903;CONVEF ADMINISTRADORA DE CONSÓRCIOS LTDA.;Recusa ou demora no fornecimento de documentos (exceto demonstrativos obrigatórios);0;0;1;1;
2018;2º;61550836;COOPERATIVA MISTA JOCKEY CLUB DE SAO PAULO;Descumprimento de cláusulas referentes à devolução de valores;0;2;0;2;
2018;2º;61550836;COOPERATIVA MISTA JOCKEY CLUB DE SAO PAULO;Insatisfação por parte do cliente com o atendimento prestado pela administradora de consórcio;0;0;1;1;
2018;2º;61550836;COOPERATIVA MISTA JOCKEY CLUB DE SAO PAULO;Irregularidades relacionadas às condições para contemplação por lance ou sorteio;1;1;0;2;
2018;2º;61550836;COOPERATIVA MISTA JOCKEY CLUB DE SAO PAULO;Outras irregularidades;1;13;0;14;
2018;2º;61550836;COOPERATIVA MISTA JOCKEY CLUB DE SAO PAULO;Prestação inadequada/insuficiente de informação;0;0;1;1;
2018;2º;61550836;COOPERATIVA MISTA JOCKEY CLUB DE SAO PAULO;Publicidade enganosa;0;0;8;8;
2018;2º;61550836;COOPERATIVA MISTA JOCKEY CLUB DE SAO PAULO;Recusa ou demora no fornecimento de documentos (exceto demonstrativos obrigatórios);0;0;2;2;
2018;2º;59395061;DISAL ADMINISTRADORA DE CONSÓRCIOS LTDA;Ausência de transparência nas relações contratuais;0;0;7;7;
2018;2º;59395061;DISAL ADMINISTRADORA DE CONSÓRCIOS LTDA;Descumprimento de cláusulas referentes à devolução de valores;1;15;0;16;
2018;2º;59395061;DISAL ADMINISTRADORA DE CONSÓRCIOS LTDA;Descumprimento de obrigações previstas em contratos;0;6;0;6;
2018;2º;59395061;DISAL ADMINISTRADORA DE CONSÓRCIOS LTDA;Descumprimento de prazo de resposta a demanda;0;2;0;2;
2018;2º;59395061;DISAL ADMINISTRADORA DE CONSÓRCIOS LTDA;Dificuldade na liberação ou substituição de bem;0;0;5;5;
2018;2º;59395061;DISAL ADMINISTRADORA DE CONSÓRCIOS LTDA;Insatisfação com a resposta fornecida pela administradora de consórcio relativa à demanda registrada contra ela;0;1;0;1;
2018;2º;59395061;DISAL ADMINISTRADORA DE CONSÓRCIOS LTDA;Insatisfação por parte do cliente com o atendimento prestado pela administradora de consórcio;0;0;6;6;
2018;2º;59395061;DISAL ADMINISTRADORA DE CONSÓRCIOS LTDA;Irregularidades relacionadas à liberação do crédito;0;28;0;28;
2018;2º;59395061;DISAL ADMINISTRADORA DE CONSÓRCIOS LTDA;Irregularidades relacionadas às condições para contemplação por lance ou sorteio;0;3;0;3;
2018;2º;59395061;DISAL ADMINISTRADORA DE CONSÓRCIOS LTDA;Outras irregularidades;1;0;0;1;
2018;2º;59395061;DISAL ADMINISTRADORA DE CONSÓRCIOS LTDA;Prestação inadequada/insuficiente de informação;0;0;10;10;
2018;2º;59395061;DISAL ADMINISTRADORA DE CONSÓRCIOS LTDA;Publicidade enganosa;0;0;1;1;
2018;2º;59395061;DISAL ADMINISTRADORA DE CONSÓRCIOS LTDA;Reclamações relacionadas a assuntos diversos;0;0;13;13;
2018;2º;59395061;DISAL ADMINISTRADORA DE CONSÓRCIOS LTDA;Recusa ou demora no fornecimento de documentos (exceto demonstrativos obrigatórios);0;0;2;2;
2018;2º;58113812;EMBRACON ADMINISTRADORA DE CONSÓRCIO LTDA;Ausência de transparência nas relações contratuais;0;0;6;6;
2018;2º;58113812;EMBRACON ADMINISTRADORA DE CONSÓRCIO LTDA;Descumprimento de cláusulas referentes à devolução de valores;0;33;0;33;
2018;2º;58113812;EMBRACON ADMINISTRADORA DE CONSÓRCIO LTDA;Descumprimento de obrigações previstas em contratos;1;14;0;15;
2018;2º;58113812;EMBRACON ADMINISTRADORA DE CONSÓRCIO LTDA;Dificuldade na liberação ou substituição de bem;0;0;5;5;
2018;2º;58113812;EMBRACON ADMINISTRADORA DE CONSÓRCIO LTDA;Insatisfação com a resposta fornecida pela administradora de consórcio relativa à demanda registrada contra ela;0;15;0;15;
2018;2º;58113812;EMBRACON ADMINISTRADORA DE CONSÓRCIO LTDA;Insatisfação por parte do cliente com o atendimento prestado pela administradora de consórcio;0;0;14;14;
2018;2º;58113812;EMBRACON ADMINISTRADORA DE CONSÓRCIO LTDA;Irregularidades relacionadas à liberação do crédito;0;36;0;36;
2018;2º;58113812;EMBRACON ADMINISTRADORA DE CONSÓRCIO LTDA;Irregularidades relacionadas às condições para contemplação por lance ou sorteio;0;6;0;6;
2018;2º;58113812;EMBRACON ADMINISTRADORA DE CONSÓRCIO LTDA;Outras irregularidades;0;5;0;5;
2018;2º;58113812;EMBRACON ADMINISTRADORA DE CONSÓRCIO LTDA;Prestação inadequada/insuficiente de informação;0;0;8;8;
2018;2º;58113812;EMBRACON ADMINISTRADORA DE CONSÓRCIO LTDA;Publicidade enganosa;0;0;6;6;
2018;2º;58113812;EMBRACON ADMINISTRADORA DE CONSÓRCIO LTDA;Reclamações relacionadas a assuntos diversos;0;0;10;10;
2018;2º;58113812;EMBRACON ADMINISTRADORA DE CONSÓRCIO LTDA;Recusa ou demora no fornecimento de documentos (exceto demonstrativos obrigatórios);0;0;5;5;
2018;2º;91107581;FARROUPILHA ADMINISTRADORA DE CONSÓRCIOS LTDA.;Descumprimento de cláusulas referentes à devolução de valores;0;1;0;1;
2018;2º;91107581;FARROUPILHA ADMINISTRADORA DE CONSÓRCIOS LTDA.;Descumprimento de prazo de resposta a demanda;1;0;0;1;
2018;2º;91107581;FARROUPILHA ADMINISTRADORA DE CONSÓRCIOS LTDA.;Insatisfação com a resposta fornecida pela administradora de consórcio relativa à demanda registrada contra ela;0;2;0;2;
2018;2º;91107581;FARROUPILHA ADMINISTRADORA DE CONSÓRCIOS LTDA.;Irregularidades relacionadas à liberação do crédito;0;1;0;1;
2018;2º;91107581;FARROUPILHA ADMINISTRADORA DE CONSÓRCIOS LTDA.;Prestação inadequada/insuficiente de informação;0;0;1;1;
2018;2º;91107581;FARROUPILHA ADMINISTRADORA DE CONSÓRCIOS LTDA.;Recusa ou demora no fornecimento de documentos (exceto demonstrativos obrigatórios);0;0;1;1;
2018;2º;00600262;FERRAZ ADMINISTRACAO E CONSORCIOS LTDA;Insatisfação por parte do cliente com o atendimento prestado pela administradora de consórcio;0;0;1;1;
2018;2º;45725975;FINAMA ADMINISTRADORA DE CONSORCIO LTDA;Prestação inadequada/insuficiente de informação;0;0;1;1;
2018;2º;04751943;FRANCAUTO ADMINISTRADORA DE CONSÓRCIO LTDA.;Ausência de transparência nas relações contratuais;0;0;1;1;
2018;2º;00643742;FUNDACAO HABITACIONAL DO EXERCITO - FHE;Insatisfação por parte do cliente com o atendimento prestado pela administradora de consórcio;0;0;1;1;
2018;2º;00643742;FUNDACAO HABITACIONAL DO EXERCITO - FHE;Reclamações relacionadas a assuntos diversos;0;0;1;1;
2018;2º;00643742;FUNDACAO HABITACIONAL DO EXERCITO - FHE;Recusa ou demora no fornecimento de documentos (exceto demonstrativos obrigatórios);0;0;2;2;
2018;2º;47820097;GAPLAN ADMINISTRADORA DE CONSÓRCIO LTDA.;Insatisfação por parte do cliente com o atendimento prestado pela administradora de consórcio;0;0;1;1;
2018;2º;85322204;GLOBO ADMINISTRADORA DE CONSÓRCIOS LTDA.;Ausência de transparência nas relações contratuais;0;0;1;1;
2018;2º;49937055;GMAC ADMINISTRADORA DE CONSORCIOS LTDA;Ausência de transparência nas relações contratuais;0;0;2;2;
2018;2º;49937055;GMAC ADMINISTRADORA DE CONSORCIOS LTDA;Cobrança irregular de tarifa pela emissão de boletos, carnês e assemelhados;0;1;0;1;
2018;2º;49937055;GMAC ADMINISTRADORA DE CONSORCIOS LTDA;Descumprimento de cláusulas referentes à devolução de valores;0;12;0;12;
2018;2º;49937055;GMAC ADMINISTRADORA DE CONSORCIOS LTDA;Descumprimento de prazo de resposta a demanda;0;3;0;3;
2018;2º;49937055;GMAC ADMINISTRADORA DE CONSORCIOS LTDA;Dificuldade na liberação ou substituição de bem;0;0;12;12;
2018;2º;49937055;GMAC ADMINISTRADORA DE CONSORCIOS LTDA;Insatisfação com a resposta fornecida pela administradora de consórcio relativa à demanda registrada contra ela;0;7;0;7;
2018;2º;49937055;GMAC ADMINISTRADORA DE CONSORCIOS LTDA;Insatisfação por parte do cliente com o atendimento prestado pela administradora de consórcio;0;0;16;16;
2018;2º;49937055;GMAC ADMINISTRADORA DE CONSORCIOS LTDA;Irregularidades relacionadas à liberação do crédito;2;44;0;46;
2018;2º;49937055;GMAC ADMINISTRADORA DE CONSORCIOS LTDA;Irregularidades relacionadas às condições para contemplação por lance ou sorteio;0;4;0;4;
2018;2º;49937055;GMAC ADMINISTRADORA DE CONSORCIOS LTDA;Outras irregularidades;2;2;0;4;
2018;2º;49937055;GMAC ADMINISTRADORA DE CONSORCIOS LTDA;Prestação inadequada/insuficiente de informação;0;0;9;9;
2018;2º;49937055;GMAC ADMINISTRADORA DE CONSORCIOS LTDA;Reclamações relacionadas a assuntos diversos;0;0;9;9;
2018;2º;49937055;GMAC ADMINISTRADORA DE CONSORCIOS LTDA;Recusa ou demora no fornecimento de documentos (exceto demonstrativos obrigatórios);0;0;5;5;
2018;2º;02798858;GOVESA ADMINISTRADORA DE CONSÓRCIOS LTDA;Ausência de transparência nas relações contratuais;0;0;1;1;
2018;2º;02798858;GOVESA ADMINISTRADORA DE CONSÓRCIOS LTDA;Insatisfação por parte do cliente com o atendimento prestado pela administradora de consórcio;0;0;1;1;
2018;2º;02798858;GOVESA ADMINISTRADORA DE CONSÓRCIOS LTDA;Irregularidades relacionadas à liberação do crédito;0;1;0;1;
2018;2º;02798858;GOVESA ADMINISTRADORA DE CONSÓRCIOS LTDA;Prestação inadequada/insuficiente de informação;0;0;2;2;
2018;2º;02798858;GOVESA ADMINISTRADORA DE CONSÓRCIOS LTDA;Publicidade enganosa;0;0;1;1;
2018;2º;02798858;GOVESA ADMINISTRADORA DE CONSÓRCIOS LTDA;Reclamações relacionadas a assuntos diversos;0;0;2;2;
2018;2º;91338228;GRAVEL ADMINISTRADORA DE CONSÓRCIOS LTDA.;Descumprimento de cláusulas referentes à devolução de valores;0;1;0;1;
2018;2º;91338228;GRAVEL ADMINISTRADORA DE CONSÓRCIOS LTDA.;Insatisfação por parte do cliente com o atendimento prestado pela administradora de consórcio;0;0;1;1;
2018;2º;26228270;GROSCON ADMINISTRADORA DE CONSORCIOS LTDA.;Irregularidades relacionadas à liberação do crédito;0;1;0;1;
2018;2º;26228270;GROSCON ADMINISTRADORA DE CONSORCIOS LTDA.;Não fornecimento, remessa ou divulgação de documentos obrigatórios;0;1;0;1;
2018;2º;26253658;GUARAPIRANGA VEÍCULOS ADMINISTRADORA DE CONSÓRCIOS LTDA.;Insatisfação por parte do cliente com o atendimento prestado pela administradora de consórcio;0;0;1;1;
2018;2º;73516106;HS ADMINISTRADORA DE CONSÓRCIOS LTDA;Ausência de transparência nas relações contratuais;0;0;2;2;
2018;2º;73516106;HS ADMINISTRADORA DE CONSÓRCIOS LTDA;Descumprimento de cláusulas referentes à devolução de valores;0;1;0;1;
2018;2º;73516106;HS ADMINISTRADORA DE CONSÓRCIOS LTDA;Descumprimento de prazo de resposta a demanda;1;0;0;1;
2018;2º;73516106;HS ADMINISTRADORA DE CONSÓRCIOS LTDA;Insatisfação por parte do cliente com o atendimento prestado pela administradora de consórcio;0;0;1;1;
2018;2º;73516106;HS ADMINISTRADORA DE CONSÓRCIOS LTDA;Irregularidades relacionadas à liberação do crédito;0;1;0;1;
2018;2º;73516106;HS ADMINISTRADORA DE CONSÓRCIOS LTDA;Prestação inadequada/insuficiente de informação;0;0;3;3;
2018;2º;73516106;HS ADMINISTRADORA DE CONSÓRCIOS LTDA;Recusa ou demora no fornecimento de documentos (exceto demonstrativos obrigatórios);0;0;1;1;
2018;2º;06181431;ITAUNA ADMINISTRADORA DE CONSORCIO LTDA;Ausência de transparência nas relações contratuais;0;0;2;2;
2018;2º;06181431;ITAUNA ADMINISTRADORA DE CONSORCIO LTDA;Descumprimento de cláusulas referentes à devolução de valores;0;2;0;2;
2018;2º;06181431;ITAUNA ADMINISTRADORA DE CONSORCIO LTDA;Reclamações relacionadas a assuntos diversos;0;0;1;1;
2018;2º;00000776;ITAÚ ADMINISTRADORA DE CONSÓRCIOS LTDA.;Cobrança irregular de tarifa pela emissão de boletos, carnês e assemelhados;1;0;0;1;
2018;2º;00000776;ITAÚ ADMINISTRADORA DE CONSÓRCIOS LTDA.;Descumprimento de cláusulas referentes à devolução de valores;0;58;0;58;
2018;2º;00000776;ITAÚ ADMINISTRADORA DE CONSÓRCIOS LTDA.;Descumprimento de obrigações previstas em contratos;12;29;0;41;
2018;2º;00000776;ITAÚ ADMINISTRADORA DE CONSÓRCIOS LTDA.;Descumprimento de prazo de resposta a demanda;0;1;0;1;
2018;2º;00000776;ITAÚ ADMINISTRADORA DE CONSÓRCIOS LTDA.;Dificuldade na liberação ou substituição de bem;0;0;17;17;
2018;2º;00000776;ITAÚ ADMINISTRADORA DE CONSÓRCIOS LTDA.;Insatisfação com a resposta fornecida pela administradora de consórcio relativa à demanda registrada contra ela;1;8;0;9;
2018;2º;00000776;ITAÚ ADMINISTRADORA DE CONSÓRCIOS LTDA.;Insatisfação por parte do cliente com o atendimento prestado pela administradora de consórcio;0;0;35;35;
2018;2º;00000776;ITAÚ ADMINISTRADORA DE CONSÓRCIOS LTDA.;Irregularidades relacionadas à liberação do crédito;4;79;0;83;
2018;2º;00000776;ITAÚ ADMINISTRADORA DE CONSÓRCIOS LTDA.;Irregularidades relacionadas às condições para contemplação por lance ou sorteio;2;1;0;3;
2018;2º;00000776;ITAÚ ADMINISTRADORA DE CONSÓRCIOS LTDA.;Outras irregularidades;1;4;0;5;
2018;2º;00000776;ITAÚ ADMINISTRADORA DE CONSÓRCIOS LTDA.;Prestação inadequada/insuficiente de informação;0;0;30;30;
2018;2º;00000776;ITAÚ ADMINISTRADORA DE CONSÓRCIOS LTDA.;Reclamações relacionadas a assuntos diversos;0;0;10;10;
2018;2º;00000776;ITAÚ ADMINISTRADORA DE CONSÓRCIOS LTDA.;Recusa ou demora no fornecimento de documentos (exceto demonstrativos obrigatórios);0;0;15;15;
2018;2º;42421776;ITAÚ UNIBANCO VEÍCULOS ADMINISTRADORA DE CONSÓRCIOS LTDA.;Cobrança irregular de tarifa pela emissão de boletos, carnês e assemelhados;0;1;0;1;
2018;2º;42421776;ITAÚ UNIBANCO VEÍCULOS ADMINISTRADORA DE CONSÓRCIOS LTDA.;Descumprimento de cláusulas referentes à devolução de valores;0;12;0;12;
2018;2º;42421776;ITAÚ UNIBANCO VEÍCULOS ADMINISTRADORA DE CONSÓRCIOS LTDA.;Descumprimento de obrigações previstas em contratos;3;6;0;9;
2018;2º;42421776;ITAÚ UNIBANCO VEÍCULOS ADMINISTRADORA DE CONSÓRCIOS LTDA.;Descumprimento de prazo para apresentação de resposta conclusiva pela Ouvidoria;0;1;0;1;
2018;2º;42421776;ITAÚ UNIBANCO VEÍCULOS ADMINISTRADORA DE CONSÓRCIOS LTDA.;Dificuldade na liberação ou substituição de bem;0;0;7;7;
2018;2º;42421776;ITAÚ UNIBANCO VEÍCULOS ADMINISTRADORA DE CONSÓRCIOS LTDA.;Insatisfação com a resposta fornecida pela administradora de consórcio relativa à demanda registrada contra ela;0;2;0;2;
2018;2º;42421776;ITAÚ UNIBANCO VEÍCULOS ADMINISTRADORA DE CONSÓRCIOS LTDA.;Insatisfação por parte do cliente com o atendimento prestado pela administradora de consórcio;0;0;7;7;
2018;2º;42421776;ITAÚ UNIBANCO VEÍCULOS ADMINISTRADORA DE CONSÓRCIOS LTDA.;Irregularidades relacionadas à liberação do crédito;2;17;0;19;
2018;2º;42421776;ITAÚ UNIBANCO VEÍCULOS ADMINISTRADORA DE CONSÓRCIOS LTDA.;Prestação inadequada/insuficiente de informação;0;0;3;3;
2018;2º;42421776;ITAÚ UNIBANCO VEÍCULOS ADMINISTRADORA DE CONSÓRCIOS LTDA.;Reclamações relacionadas a assuntos diversos;0;0;2;2;
2018;2º;42421776;ITAÚ UNIBANCO VEÍCULOS ADMINISTRADORA DE CONSÓRCIOS LTDA.;Recusa ou demora no fornecimento de documentos (exceto demonstrativos obrigatórios);0;0;6;6;
2018;2º;60250776;LUIZA ADMINISTRADORA DE CONSÓRCIOS LTDA;Descumprimento de cláusulas referentes à devolução de valores;0;3;0;3;
2018;2º;60250776;LUIZA ADMINISTRADORA DE CONSÓRCIOS LTDA;Dificuldade na liberação ou substituição de bem;0;0;1;1;
2018;2º;60250776;LUIZA ADMINISTRADORA DE CONSÓRCIOS LTDA;Insatisfação com a resposta fornecida pela administradora de consórcio relativa à demanda registrada contra ela;1;1;0;2;
2018;2º;60250776;LUIZA ADMINISTRADORA DE CONSÓRCIOS LTDA;Insatisfação por parte do cliente com o atendimento prestado pela administradora de consórcio;0;0;3;3;
2018;2º;60250776;LUIZA ADMINISTRADORA DE CONSÓRCIOS LTDA;Irregularidades relacionadas à liberação do crédito;0;1;0;1;
2018;2º;60250776;LUIZA ADMINISTRADORA DE CONSÓRCIOS LTDA;Reclamações relacionadas a assuntos diversos;0;0;2;2;
2018;2º;04250224;MAGGI ADMINISTRADORA DE CONSÓRCIOS LTDA;Insatisfação por parte do cliente com o atendimento prestado pela administradora de consórcio;0;0;1;1;
2018;2º;04250224;MAGGI ADMINISTRADORA DE CONSÓRCIOS LTDA;Irregularidades relacionadas à liberação do crédito;0;1;0;1;
2018;2º;04250224;MAGGI ADMINISTRADORA DE CONSÓRCIOS LTDA;Irregularidades relacionadas às condições para contemplação por lance ou sorteio;0;1;0;1;
2018;2º;04250224;MAGGI ADMINISTRADORA DE CONSÓRCIOS LTDA;Recusa ou demora no fornecimento de documentos (exceto demonstrativos obrigatórios);0;0;1;1;
2018;2º;45793395;MASSEY FERGUSON ADMINISTRADORA DE CONSÓRCIOS LTDA;Ausência de transparência nas relações contratuais;0;0;1;1;
2018;2º;45793395;MASSEY FERGUSON ADMINISTRADORA DE CONSÓRCIOS LTDA;Insatisfação com a resposta fornecida pela administradora de consórcio relativa à demanda registrada contra ela;0;1;0;1;
2018;2º;45793395;MASSEY FERGUSON ADMINISTRADORA DE CONSÓRCIOS LTDA;Irregularidades relacionadas às condições para contemplação por lance ou sorteio;0;1;0;1;
2018;2º;45793395;MASSEY FERGUSON ADMINISTRADORA DE CONSÓRCIOS LTDA;Prestação inadequada/insuficiente de informação;0;0;2;2;
2018;2º;76853043;MENEGALLI ADMINISTRADORA DE CONSÓRCIOS LTDA;Reclamações relacionadas a assuntos diversos;0;0;1;1;
2018;2º;46349106;MERCABENCO MERCANTIL E ADMINISTRADORA DE BENS E CONSÓRCIOS LTDA.;Prestação inadequada/insuficiente de informação;0;0;1;1;
2018;2º;05126027;MOTOASA ADMINISTRADORA DE CONSÓRCIOS LTDA.;Outras irregularidades;1;0;0;1;
2018;2º;04124922;MULTIMARCAS ADMINISTRADORA DE CONSORCIOS LTDA.;Ausência de transparência nas relações contratuais;0;0;2;2;
2018;2º;04124922;MULTIMARCAS ADMINISTRADORA DE CONSORCIOS LTDA.;Descumprimento de cláusulas referentes à devolução de valores;0;9;0;9;
2018;2º;04124922;MULTIMARCAS ADMINISTRADORA DE CONSORCIOS LTDA.;Insatisfação com a resposta fornecida pela administradora de consórcio relativa à demanda registrada contra ela;0;4;0;4;
2018;2º;04124922;MULTIMARCAS ADMINISTRADORA DE CONSORCIOS LTDA.;Insatisfação por parte do cliente com o atendimento prestado pela administradora de consórcio;0;0;2;2;
2018;2º;04124922;MULTIMARCAS ADMINISTRADORA DE CONSORCIOS LTDA.;Outras irregularidades;15;30;0;45;
2018;2º;04124922;MULTIMARCAS ADMINISTRADORA DE CONSORCIOS LTDA.;Prestação inadequada/insuficiente de informação;0;0;2;2;
2018;2º;04124922;MULTIMARCAS ADMINISTRADORA DE CONSORCIOS LTDA.;Publicidade enganosa;0;0;3;3;
2018;2º;04124922;MULTIMARCAS ADMINISTRADORA DE CONSORCIOS LTDA.;Reclamações relacionadas a assuntos diversos;0;0;2;2;
2018;2º;05652765;NANUQUE ADMINISTRADORA DE CONSÓRCIOS LTDA.;Recusa ou demora no fornecimento de documentos (exceto demonstrativos obrigatórios);0;0;1;1;
2018;2º;05395814;NOVOTEMPO ADMINISTRADORA DE CONSORCIOS LTDA.;Irregularidades relacionadas à liberação do crédito;0;1;0;1;
2018;2º;50533876;PAN ADMINISTRADORA DE CONSORCIO LTDA;Ausência de transparência nas relações contratuais;0;0;2;2;
2018;2º;50533876;PAN ADMINISTRADORA DE CONSORCIO LTDA;Descumprimento de cláusulas referentes à devolução de valores;1;1;0;2;
2018;2º;50533876;PAN ADMINISTRADORA DE CONSORCIO LTDA;Descumprimento de obrigações previstas em contratos;1;2;0;3;
2018;2º;50533876;PAN ADMINISTRADORA DE CONSORCIO LTDA;Dificuldade na liberação ou substituição de bem;0;0;1;1;
2018;2º;50533876;PAN ADMINISTRADORA DE CONSORCIO LTDA;Insatisfação com a resposta fornecida pela administradora de consórcio relativa à demanda registrada contra ela;0;2;0;2;
2018;2º;50533876;PAN ADMINISTRADORA DE CONSORCIO LTDA;Insatisfação por parte do cliente com o atendimento prestado pela administradora de consórcio;0;0;2;2;
2018;2º;50533876;PAN ADMINISTRADORA DE CONSORCIO LTDA;Irregularidades relacionadas à liberação do crédito;0;1;0;1;
2018;2º;50533876;PAN ADMINISTRADORA DE CONSORCIO LTDA;Irregularidades relacionadas às condições para contemplação por lance ou sorteio;1;0;0;1;
2018;2º;50533876;PAN ADMINISTRADORA DE CONSORCIO LTDA;Não fornecimento, remessa ou divulgação de documentos obrigatórios;1;0;0;1;
2018;2º;50533876;PAN ADMINISTRADORA DE CONSORCIO LTDA;Outras irregularidades;2;3;0;5;
2018;2º;50533876;PAN ADMINISTRADORA DE CONSORCIO LTDA;Prestação inadequada/insuficiente de informação;0;0;13;13;
2018;2º;50533876;PAN ADMINISTRADORA DE CONSORCIO LTDA;Publicidade enganosa;0;0;7;7;
2018;2º;50533876;PAN ADMINISTRADORA DE CONSORCIO LTDA;Recusa ou demora no fornecimento de documentos (exceto demonstrativos obrigatórios);0;0;8;8;
2018;2º;16551061;PONTA ADMINISTRADORA DE CONSORCIOS LTDA;Descumprimento de cláusulas referentes à devolução de valores;0;2;0;2;
2018;2º;16551061;PONTA ADMINISTRADORA DE CONSORCIOS LTDA;Dificuldade na liberação ou substituição de bem;0;0;1;1;
2018;2º;16551061;PONTA ADMINISTRADORA DE CONSORCIOS LTDA;Insatisfação com a resposta fornecida pela administradora de consórcio relativa à demanda registrada contra ela;1;0;0;1;
2018;2º;16551061;PONTA ADMINISTRADORA DE CONSORCIOS LTDA;Insatisfação por parte do cliente com o atendimento prestado pela administradora de consórcio;0;0;1;1;
2018;2º;16551061;PONTA ADMINISTRADORA DE CONSORCIOS LTDA;Irregularidades relacionadas à liberação do crédito;1;10;0;11;
2018;2º;16551061;PONTA ADMINISTRADORA DE CONSORCIOS LTDA;Outras irregularidades;0;1;0;1;
2018;2º;16551061;PONTA ADMINISTRADORA DE CONSORCIOS LTDA;Prestação inadequada/insuficiente de informação;0;0;2;2;
2018;2º;16551061;PONTA ADMINISTRADORA DE CONSORCIOS LTDA;Reclamações relacionadas a assuntos diversos;0;0;6;6;
2018;2º;48041735;PORTO SEGURO ADMINISTRADORA DE CONSÓRCIOS LTDA;Ausência de transparência nas relações contratuais;0;0;3;3;
2018;2º;48041735;PORTO SEGURO ADMINISTRADORA DE CONSÓRCIOS LTDA;Descumprimento de cláusulas referentes à devolução de valores;0;9;0;9;
2018;2º;48041735;PORTO SEGURO ADMINISTRADORA DE CONSÓRCIOS LTDA;Descumprimento de obrigações previstas em contratos;0;4;0;4;
2018;2º;48041735;PORTO SEGURO ADMINISTRADORA DE CONSÓRCIOS LTDA;Dificuldade na liberação ou substituição de bem;0;0;1;1;
2018;2º;48041735;PORTO SEGURO ADMINISTRADORA DE CONSÓRCIOS LTDA;Insatisfação com a resposta fornecida pela administradora de consórcio relativa à demanda registrada contra ela;0;5;0;5;
2018;2º;48041735;PORTO SEGURO ADMINISTRADORA DE CONSÓRCIOS LTDA;Insatisfação por parte do cliente com o atendimento prestado pela administradora de consórcio;0;0;8;8;
2018;2º;48041735;PORTO SEGURO ADMINISTRADORA DE CONSÓRCIOS LTDA;Irregularidades relacionadas à liberação do crédito;0;11;0;11;
2018;2º;48041735;PORTO SEGURO ADMINISTRADORA DE CONSÓRCIOS LTDA;Irregularidades relacionadas às condições para contemplação por lance ou sorteio;0;1;0;1;
2018;2º;48041735;PORTO SEGURO ADMINISTRADORA DE CONSÓRCIOS LTDA;Prestação inadequada/insuficiente de informação;0;0;9;9;
2018;2º;48041735;PORTO SEGURO ADMINISTRADORA DE CONSÓRCIOS LTDA;Reclamações relacionadas a assuntos diversos;0;0;15;15;
2018;2º;87433413;PORTOBENS ADMINISTRADORA DE CONSORCIOS LTDA;Ausência de transparência nas relações contratuais;0;0;1;1;
2018;2º;87433413;PORTOBENS ADMINISTRADORA DE CONSORCIOS LTDA;Dificuldade na liberação ou substituição de bem;0;0;1;1;
2018;2º;87433413;PORTOBENS ADMINISTRADORA DE CONSORCIOS LTDA;Irregularidades relacionadas à liberação do crédito;0;1;0;1;
2018;2º;87433413;PORTOBENS ADMINISTRADORA DE CONSORCIOS LTDA;Reclamações relacionadas a assuntos diversos;0;0;1;1;
2018;2º;51597300;PRIMO ROSSI ADMINISTRADORA DE CONSÓRCIO LTDA.;Ausência de transparência nas relações contratuais;0;0;1;1;
2018;2º;51597300;PRIMO ROSSI ADMINISTRADORA DE CONSÓRCIO LTDA.;Descumprimento de cláusulas referentes à devolução de valores;0;1;0;1;
2018;2º;51597300;PRIMO ROSSI ADMINISTRADORA DE CONSÓRCIO LTDA.;Insatisfação com a resposta fornecida pela administradora de consórcio relativa à demanda registrada contra ela;0;1;0;1;
2018;2º;51597300;PRIMO ROSSI ADMINISTRADORA DE CONSÓRCIO LTDA.;Insatisfação por parte do cliente com o atendimento prestado pela administradora de consórcio;0;0;1;1;
2018;2º;51597300;PRIMO ROSSI ADMINISTRADORA DE CONSÓRCIO LTDA.;Irregularidades relacionadas às condições para contemplação por lance ou sorteio;1;2;0;3;
2018;2º;51597300;PRIMO ROSSI ADMINISTRADORA DE CONSÓRCIO LTDA.;Não fornecimento, remessa ou divulgação de documentos obrigatórios;5;1;0;6;
2018;2º;51597300;PRIMO ROSSI ADMINISTRADORA DE CONSÓRCIO LTDA.;Prestação inadequada/insuficiente de informação;0;0;3;3;
2018;2º;51597300;PRIMO ROSSI ADMINISTRADORA DE CONSÓRCIO LTDA.;Reclamações relacionadas a assuntos diversos;0;0;1;1;
2018;2º;91108027;RANDON ADMINISTRADORA DE CONSÓRCIOS LTDA.;Dificuldade na liberação ou substituição de bem;0;0;1;1;
2018;2º;91108027;RANDON ADMINISTRADORA DE CONSÓRCIOS LTDA.;Insatisfação por parte do cliente com o atendimento prestado pela administradora de consórcio;0;0;1;1;
2018;2º;91108027;RANDON ADMINISTRADORA DE CONSÓRCIOS LTDA.;Outras irregularidades;1;0;0;1;
2018;2º;91108027;RANDON ADMINISTRADORA DE CONSÓRCIOS LTDA.;Prestação inadequada/insuficiente de informação;0;0;1;1;
2018;2º;66228966;REALIZA ADMINISTRADORA DE CONSÓRCIOS LTDA.;Ausência de transparência nas relações contratuais;0;0;1;1;
2018;2º;66228966;REALIZA ADMINISTRADORA DE CONSÓRCIOS LTDA.;Descumprimento de cláusulas referentes à devolução de valores;0;8;0;8;
2018;2º;66228966;REALIZA ADMINISTRADORA DE CONSÓRCIOS LTDA.;Descumprimento de obrigações previstas em contratos;0;4;0;4;
2018;2º;66228966;REALIZA ADMINISTRADORA DE CONSÓRCIOS LTDA.;Dificuldade na liberação ou substituição de bem;0;0;1;1;
2018;2º;66228966;REALIZA ADMINISTRADORA DE CONSÓRCIOS LTDA.;Insatisfação com a resposta fornecida pela administradora de consórcio relativa à demanda registrada contra ela;0;2;0;2;
2018;2º;66228966;REALIZA ADMINISTRADORA DE CONSÓRCIOS LTDA.;Insatisfação por parte do cliente com o atendimento prestado pela administradora de consórcio;0;0;3;3;
2018;2º;66228966;REALIZA ADMINISTRADORA DE CONSÓRCIOS LTDA.;Irregularidades relacionadas à liberação do crédito;0;1;0;1;
2018;2º;66228966;REALIZA ADMINISTRADORA DE CONSÓRCIOS LTDA.;Irregularidades relacionadas às condições para contemplação por lance ou sorteio;0;1;0;1;
2018;2º;66228966;REALIZA ADMINISTRADORA DE CONSÓRCIOS LTDA.;Outras irregularidades;0;1;0;1;
2018;2º;66228966;REALIZA ADMINISTRADORA DE CONSÓRCIOS LTDA.;Prestação inadequada/insuficiente de informação;0;0;6;6;
2018;2º;66228966;REALIZA ADMINISTRADORA DE CONSÓRCIOS LTDA.;Publicidade enganosa;0;0;19;19;
2018;2º;66228966;REALIZA ADMINISTRADORA DE CONSÓRCIOS LTDA.;Reclamações relacionadas a assuntos diversos;0;0;3;3;
2018;2º;66228966;REALIZA ADMINISTRADORA DE CONSÓRCIOS LTDA.;Recusa ou demora no fornecimento de documentos (exceto demonstrativos obrigatórios);0;0;1;1;
2018;2º;23767155;RECON ADMINISTRADORA DE CONSORCIOS LTDA;Ausência de transparência nas relações contratuais;0;0;2;2;
2018;2º;23767155;RECON ADMINISTRADORA DE CONSORCIOS LTDA;Descumprimento de obrigações previstas em contratos;0;1;0;1;
2018;2º;23767155;RECON ADMINISTRADORA DE CONSORCIOS LTDA;Irregularidades relacionadas à liberação do crédito;0;2;0;2;
2018;2º;23767155;RECON ADMINISTRADORA DE CONSORCIOS LTDA;Prestação inadequada/insuficiente de informação;0;0;2;2;
2018;2º;23767155;RECON ADMINISTRADORA DE CONSORCIOS LTDA;Publicidade enganosa;0;0;1;1;
2018;2º;62246228;REDENÇÃO ADMINISTRADORA DE CONSÓRCIO LTDA.;Descumprimento de cláusulas referentes à devolução de valores;0;1;0;1;
2018;2º;62354055;REMAZA ADMINISTRADORA DE CONSÓRCIO LTDA.;Ausência de transparência nas relações contratuais;0;0;2;2;
2018;2º;62354055;REMAZA ADMINISTRADORA DE CONSÓRCIO LTDA.;Cobrança irregular de tarifa pela emissão de boletos, carnês e assemelhados;0;2;0;2;
2018;2º;62354055;REMAZA ADMINISTRADORA DE CONSÓRCIO LTDA.;Descumprimento de cláusulas referentes à devolução de valores;0;9;0;9;
2018;2º;62354055;REMAZA ADMINISTRADORA DE CONSÓRCIO LTDA.;Descumprimento de obrigações previstas em contratos;0;1;0;1;
2018;2º;62354055;REMAZA ADMINISTRADORA DE CONSÓRCIO LTDA.;Descumprimento de prazo de resposta a demanda;0;1;0;1;
2018;2º;62354055;REMAZA ADMINISTRADORA DE CONSÓRCIO LTDA.;Insatisfação com a resposta fornecida pela administradora de consórcio relativa à demanda registrada contra ela;1;3;0;4;
2018;2º;62354055;REMAZA ADMINISTRADORA DE CONSÓRCIO LTDA.;Insatisfação por parte do cliente com o atendimento prestado pela administradora de consórcio;0;0;1;1;
2018;2º;62354055;REMAZA ADMINISTRADORA DE CONSÓRCIO LTDA.;Irregularidades relacionadas à liberação do crédito;0;7;0;7;
2018;2º;62354055;REMAZA ADMINISTRADORA DE CONSÓRCIO LTDA.;Irregularidades relacionadas às condições para contemplação por lance ou sorteio;0;4;0;4;
2018;2º;62354055;REMAZA ADMINISTRADORA DE CONSÓRCIO LTDA.;Prestação inadequada/insuficiente de informação;0;0;2;2;
2018;2º;62354055;REMAZA ADMINISTRADORA DE CONSÓRCIO LTDA.;Publicidade enganosa;0;0;14;14;
2018;2º;62354055;REMAZA ADMINISTRADORA DE CONSÓRCIO LTDA.;Reclamações relacionadas a assuntos diversos;0;0;2;2;
2018;2º;62354055;REMAZA ADMINISTRADORA DE CONSÓRCIO LTDA.;Recusa ou demora no fornecimento de documentos (exceto demonstrativos obrigatórios);0;0;1;1;
2018;2º;80402746;RIVEL ADMINISTRADORA DE CONSÓRCIOS LTDA.;Irregularidades relacionadas à liberação do crédito;0;1;0;1;
2018;2º;51855716;RODOBENS ADMINISTRADORA DE CONSÓRCIOS LTDA.;Ausência de transparência nas relações contratuais;0;0;5;5;
2018;2º;51855716;RODOBENS ADMINISTRADORA DE CONSÓRCIOS LTDA.;Descumprimento de cláusulas referentes à devolução de valores;0;7;0;7;
2018;2º;51855716;RODOBENS ADMINISTRADORA DE CONSÓRCIOS LTDA.;Descumprimento de obrigações previstas em contratos;1;1;0;2;
2018;2º;51855716;RODOBENS ADMINISTRADORA DE CONSÓRCIOS LTDA.;Dificuldade na liberação ou substituição de bem;0;0;3;3;
2018;2º;51855716;RODOBENS ADMINISTRADORA DE CONSÓRCIOS LTDA.;Insatisfação com a resposta fornecida pela administradora de consórcio relativa à demanda registrada contra ela;0;7;0;7;
2018;2º;51855716;RODOBENS ADMINISTRADORA DE CONSÓRCIOS LTDA.;Insatisfação por parte do cliente com o atendimento prestado pela administradora de consórcio;0;0;14;14;
2018;2º;51855716;RODOBENS ADMINISTRADORA DE CONSÓRCIOS LTDA.;Irregularidades relacionadas à liberação do crédito;0;16;0;16;
2018;2º;51855716;RODOBENS ADMINISTRADORA DE CONSÓRCIOS LTDA.;Irregularidades relacionadas às condições para contemplação por lance ou sorteio;0;2;0;2;
2018;2º;51855716;RODOBENS ADMINISTRADORA DE CONSÓRCIOS LTDA.;Outras irregularidades;1;4;0;5;
2018;2º;51855716;RODOBENS ADMINISTRADORA DE CONSÓRCIOS LTDA.;Prestação inadequada/insuficiente de informação;0;0;11;11;
2018;2º;51855716;RODOBENS ADMINISTRADORA DE CONSÓRCIOS LTDA.;Reclamações relacionadas a assuntos diversos;0;0;7;7;
2018;2º;51855716;RODOBENS ADMINISTRADORA DE CONSÓRCIOS LTDA.;Recusa ou demora no fornecimento de documentos (exceto demonstrativos obrigatórios);0;0;7;7;
2018;2º;55942312;SANTANDER BRASIL ADMINISTRADORA DE CONSÓRCIO LTDA.;Ausência de informações/cláusulas obrigatórias em contrato;1;0;0;1;
2018;2º;55942312;SANTANDER BRASIL ADMINISTRADORA DE CONSÓRCIO LTDA.;Ausência de transparência nas relações contratuais;0;0;1;1;
2018;2º;55942312;SANTANDER BRASIL ADMINISTRADORA DE CONSÓRCIO LTDA.;Cobrança irregular de tarifa pela emissão de boletos, carnês e assemelhados;0;3;0;3;
2018;2º;55942312;SANTANDER BRASIL ADMINISTRADORA DE CONSÓRCIO LTDA.;Descumprimento de cláusulas referentes à devolução de valores;0;7;0;7;
2018;2º;55942312;SANTANDER BRASIL ADMINISTRADORA DE CONSÓRCIO LTDA.;Descumprimento de obrigações previstas em contratos;1;4;0;5;
2018;2º;55942312;SANTANDER BRASIL ADMINISTRADORA DE CONSÓRCIO LTDA.;Descumprimento de prazo de resposta a demanda;0;4;0;4;
2018;2º;55942312;SANTANDER BRASIL ADMINISTRADORA DE CONSÓRCIO LTDA.;Dificuldade na liberação ou substituição de bem;0;0;4;4;
2018;2º;55942312;SANTANDER BRASIL ADMINISTRADORA DE CONSÓRCIO LTDA.;Insatisfação com a resposta fornecida pela administradora de consórcio relativa à demanda registrada contra ela;0;2;0;2;
2018;2º;55942312;SANTANDER BRASIL ADMINISTRADORA DE CONSÓRCIO LTDA.;Insatisfação por parte do cliente com o atendimento prestado pela administradora de consórcio;0;0;7;7;
2018;2º;55942312;SANTANDER BRASIL ADMINISTRADORA DE CONSÓRCIO LTDA.;Irregularidades relacionadas à liberação do crédito;1;16;0;17;
2018;2º;55942312;SANTANDER BRASIL ADMINISTRADORA DE CONSÓRCIO LTDA.;Irregularidades relacionadas às condições para contemplação por lance ou sorteio;0;4;0;4;
2018;2º;55942312;SANTANDER BRASIL ADMINISTRADORA DE CONSÓRCIO LTDA.;Prestação inadequada/insuficiente de informação;0;0;7;7;
2018;2º;55942312;SANTANDER BRASIL ADMINISTRADORA DE CONSÓRCIO LTDA.;Reclamações relacionadas a assuntos diversos;0;0;15;15;
2018;2º;55942312;SANTANDER BRASIL ADMINISTRADORA DE CONSÓRCIO LTDA.;Recusa ou demora no fornecimento de documentos (exceto demonstrativos obrigatórios);0;0;3;3;
2018;2º;96479258;SCANIA ADMINISTRADORA DE CONSÓRCIOS LTDA.;Insatisfação por parte do cliente com o atendimento prestado pela administradora de consórcio;0;0;1;1;
2018;2º;96479258;SCANIA ADMINISTRADORA DE CONSÓRCIOS LTDA.;Publicidade enganosa;0;0;1;1;
2018;2º;76515071;SERVOPA ADMINISTRADORA DE CONSORCIOS LTDA;Ausência de transparência nas relações contratuais;0;0;2;2;
2018;2º;76515071;SERVOPA ADMINISTRADORA DE CONSORCIOS LTDA;Descumprimento de cláusulas referentes à devolução de valores;0;1;0;1;
2018;2º;76515071;SERVOPA ADMINISTRADORA DE CONSORCIOS LTDA;Insatisfação com a resposta fornecida pela administradora de consórcio relativa à demanda registrada contra ela;0;1;0;1;
2018;2º;76515071;SERVOPA ADMINISTRADORA DE CONSORCIOS LTDA;Insatisfação por parte do cliente com o atendimento prestado pela administradora de consórcio;0;0;1;1;
2018;2º;76515071;SERVOPA ADMINISTRADORA DE CONSORCIOS LTDA;Irregularidades relacionadas às condições para contemplação por lance ou sorteio;0;1;0;1;
2018;2º;76515071;SERVOPA ADMINISTRADORA DE CONSORCIOS LTDA;Publicidade enganosa;0;0;1;1;
2018;2º;76515071;SERVOPA ADMINISTRADORA DE CONSORCIOS LTDA;Reclamações relacionadas a assuntos diversos;0;0;2;2;
2018;2º;87945218;SIMPALA LANÇADORA E ADMINISTRADORA DE CONSÓRCIOS LTDA.;Irregularidades relacionadas às condições para contemplação por lance ou sorteio;0;1;0;1;
2018;2º;87852273;SINOSSERRA ADMINISTRADORA DE CONSÓRCIOS LTDA;Insatisfação por parte do cliente com o atendimento prestado pela administradora de consórcio;0;0;1;1;
2018;2º;87852273;SINOSSERRA ADMINISTRADORA DE CONSÓRCIOS LTDA;Prestação inadequada/insuficiente de informação;0;0;1;1;
2018;2º;87852273;SINOSSERRA ADMINISTRADORA DE CONSÓRCIOS LTDA;Publicidade enganosa;0;0;1;1;
2018;2º;87636635;SPONCHIADO ADMINISTRADORA DE CONSÓRCIOS LTDA.;Ausência de transparência nas relações contratuais;0;0;1;1;
2018;2º;87636635;SPONCHIADO ADMINISTRADORA DE CONSÓRCIOS LTDA.;Descumprimento de cláusulas referentes à devolução de valores;0;1;0;1;
2018;2º;87636635;SPONCHIADO ADMINISTRADORA DE CONSÓRCIOS LTDA.;Descumprimento de obrigações previstas em contratos;0;1;0;1;
2018;2º;87636635;SPONCHIADO ADMINISTRADORA DE CONSÓRCIOS LTDA.;Irregularidades relacionadas às condições para contemplação por lance ou sorteio;0;1;0;1;
2018;2º;87636635;SPONCHIADO ADMINISTRADORA DE CONSÓRCIOS LTDA.;Prestação inadequada/insuficiente de informação;0;0;1;1;
2018;2º;87636635;SPONCHIADO ADMINISTRADORA DE CONSÓRCIOS LTDA.;Publicidade enganosa;0;0;1;1;
2018;2º;57723801;SUZUKI MOTOS ADMINISTRADORA DE CONSÓRCIO LTDA.;Cobrança irregular de tarifa pela emissão de boletos, carnês e assemelhados;0;2;0;2;
2018;2º;57723801;SUZUKI MOTOS ADMINISTRADORA DE CONSÓRCIO LTDA.;Descumprimento de cláusulas referentes à devolução de valores;0;1;0;1;
2018;2º;57723801;SUZUKI MOTOS ADMINISTRADORA DE CONSÓRCIO LTDA.;Insatisfação com a resposta fornecida pela administradora de consórcio relativa à demanda registrada contra ela;0;1;0;1;
2018;2º;57723801;SUZUKI MOTOS ADMINISTRADORA DE CONSÓRCIO LTDA.;Irregularidades relacionadas à liberação do crédito;0;2;0;2;
2018;2º;53211488;TARRAF ADMINISTRADORA DE CONSÓRCIOS LTDA.;Insatisfação com a resposta fornecida pela administradora de consórcio relativa à demanda registrada contra ela;0;1;0;1;
2018;2º;53211488;TARRAF ADMINISTRADORA DE CONSÓRCIOS LTDA.;Irregularidades relacionadas às condições para contemplação por lance ou sorteio;0;1;0;1;
2018;2º;53211488;TARRAF ADMINISTRADORA DE CONSÓRCIOS LTDA.;Recusa ou demora no fornecimento de documentos (exceto demonstrativos obrigatórios);0;0;1;1;
2018;2º;05551841;TÁGIDE ADMINISTRADORA DE CONSÓRCIOS LTDA.;Descumprimento de cláusulas referentes à devolução de valores;0;1;0;1;
2018;2º;59956185;TRADIÇÃO ADMINISTRADORA DE CONSÓRCIO LTDA.;Dificuldade na liberação ou substituição de bem;0;0;1;1;
2018;2º;59956185;TRADIÇÃO ADMINISTRADORA DE CONSÓRCIO LTDA.;Insatisfação com a resposta fornecida pela administradora de consórcio relativa à demanda registrada contra ela;1;0;0;1;
2018;2º;59956185;TRADIÇÃO ADMINISTRADORA DE CONSÓRCIO LTDA.;Irregularidades relacionadas às condições para contemplação por lance ou sorteio;0;1;0;1;
2018;2º;59956185;TRADIÇÃO ADMINISTRADORA DE CONSÓRCIO LTDA.;Publicidade enganosa;0;0;1;1;
2018;2º;59956185;TRADIÇÃO ADMINISTRADORA DE CONSÓRCIO LTDA.;Reclamações relacionadas a assuntos diversos;0;0;1;1;
2018;2º;83553883;UNIÃO CATARINENSE ADMINISTRADORA DE CONSORCIOS LTDA;Prestação inadequada/insuficiente de informação;0;0;1;1;
2018;2º;60732997;UNIFISA ADMINISTRADORA NACIONAL DE CONSORCIOS LTDA;Ausência de transparência nas relações contratuais;0;0;1;1;
2018;2º;60732997;UNIFISA ADMINISTRADORA NACIONAL DE CONSORCIOS LTDA;Cobrança irregular de tarifa pela emissão de boletos, carnês e assemelhados;0;1;0;1;
2018;2º;60732997;UNIFISA ADMINISTRADORA NACIONAL DE CONSORCIOS LTDA;Descumprimento de cláusulas referentes à devolução de valores;0;2;0;2;
2018;2º;60732997;UNIFISA ADMINISTRADORA NACIONAL DE CONSORCIOS LTDA;Descumprimento de obrigações previstas em contratos;0;1;0;1;
2018;2º;60732997;UNIFISA ADMINISTRADORA NACIONAL DE CONSORCIOS LTDA;Descumprimento de prazo de resposta a demanda;0;1;0;1;
2018;2º;60732997;UNIFISA ADMINISTRADORA NACIONAL DE CONSORCIOS LTDA;Insatisfação com a resposta fornecida pela administradora de consórcio relativa à demanda registrada contra ela;0;2;0;2;
2018;2º;60732997;UNIFISA ADMINISTRADORA NACIONAL DE CONSORCIOS LTDA;Irregularidades relacionadas à liberação do crédito;0;4;0;4;
2018;2º;60732997;UNIFISA ADMINISTRADORA NACIONAL DE CONSORCIOS LTDA;Irregularidades relacionadas às condições para contemplação por lance ou sorteio;0;1;0;1;
2018;2º;60732997;UNIFISA ADMINISTRADORA NACIONAL DE CONSORCIOS LTDA;Não fornecimento, remessa ou divulgação de documentos obrigatórios;0;1;0;1;
2018;2º;60732997;UNIFISA ADMINISTRADORA NACIONAL DE CONSORCIOS LTDA;Outras irregularidades;0;1;0;1;
2018;2º;60732997;UNIFISA ADMINISTRADORA NACIONAL DE CONSORCIOS LTDA;Prestação inadequada/insuficiente de informação;0;0;4;4;
2018;2º;60732997;UNIFISA ADMINISTRADORA NACIONAL DE CONSORCIOS LTDA;Publicidade enganosa;0;0;2;2;
2018;2º;60732997;UNIFISA ADMINISTRADORA NACIONAL DE CONSORCIOS LTDA;Reclamações relacionadas a assuntos diversos;0;0;1;1;
2018;2º;56360266;VALTRA ADMINISTRADORA DE CONSÓRCIOS LTDA;Irregularidades relacionadas à liberação do crédito;0;1;0;1;
2018;2º;56360266;VALTRA ADMINISTRADORA DE CONSÓRCIOS LTDA;Outras irregularidades;0;1;0;1;
2018;2º;49995293;VINAC ADMINISTRADORA DE CONSÓRCIOS LTDA.;Prestação inadequada/insuficiente de informação;0;0;1;1;
2018;2º;74118381;VOLVO ADMINISTRADORA DE CONSÓRCIO LTDA.;Ausência de transparência nas relações contratuais;0;0;1;1;
2018;2º;74118381;VOLVO ADMINISTRADORA DE CONSÓRCIO LTDA.;Descumprimento de cláusulas referentes à devolução de valores;0;2;0;2;
2018;2º;74118381;VOLVO ADMINISTRADORA DE CONSÓRCIO LTDA.;Dificuldade na liberação ou substituição de bem;0;0;3;3;
2018;2º;74118381;VOLVO ADMINISTRADORA DE CONSÓRCIO LTDA.;Insatisfação com a resposta fornecida pela administradora de consórcio relativa à demanda registrada contra ela;0;1;0;1;
2018;2º;47458153;YAMAHA ADMINISTRADORA DE CONSÓRCIO LTDA.;Ausência de informações/cláusulas obrigatórias em contrato;1;0;0;1;
2018;2º;47458153;YAMAHA ADMINISTRADORA DE CONSÓRCIO LTDA.;Ausência de transparência nas relações contratuais;0;0;3;3;
2018;2º;47458153;YAMAHA ADMINISTRADORA DE CONSÓRCIO LTDA.;Descumprimento de cláusulas referentes à devolução de valores;1;1;0;2;
2018;2º;47458153;YAMAHA ADMINISTRADORA DE CONSÓRCIO LTDA.;Dificuldade na liberação ou substituição de bem;0;0;4;4;
2018;2º;47458153;YAMAHA ADMINISTRADORA DE CONSÓRCIO LTDA.;Insatisfação com a resposta fornecida pela administradora de consórcio relativa à demanda registrada contra ela;0;2;0;2;
2018;2º;47458153;YAMAHA ADMINISTRADORA DE CONSÓRCIO LTDA.;Insatisfação por parte do cliente com o atendimento prestado pela administradora de consórcio;0;0;6;6;
2018;2º;47458153;YAMAHA ADMINISTRADORA DE CONSÓRCIO LTDA.;Irregularidades relacionadas à liberação do crédito;0;3;0;3;
2018;2º;47458153;YAMAHA ADMINISTRADORA DE CONSÓRCIO LTDA.;Recusa ou demora no fornecimento de documentos (exceto demonstrativos obrigatórios);0;0;1;1;
2018;2º;23367634;ZEMA ADMINISTRADORA DE CONSÓRCIO LTDA;Ausência de transparência nas relações contratuais;0;0;1;1;
2018;2º;23367634;ZEMA ADMINISTRADORA DE CONSÓRCIO LTDA;Cobrança irregular de tarifa pela emissão de boletos, carnês e assemelhados;0;1;0;1;
2018;2º;23367634;ZEMA ADMINISTRADORA DE CONSÓRCIO LTDA;Descumprimento de cláusulas referentes à devolução de valores;1;5;0;6;
2018;2º;23367634;ZEMA ADMINISTRADORA DE CONSÓRCIO LTDA;Descumprimento de obrigações previstas em contratos;0;1;0;1;
2018;2º;23367634;ZEMA ADMINISTRADORA DE CONSÓRCIO LTDA;Descumprimento de prazo de resposta a demanda;0;1;0;1;
2018;2º;23367634;ZEMA ADMINISTRADORA DE CONSÓRCIO LTDA;Irregularidades relacionadas às condições para contemplação por lance ou sorteio;0;2;0;2;
2018;2º;23367634;ZEMA ADMINISTRADORA DE CONSÓRCIO LTDA;Prestação inadequada/insuficiente de informação;0;0;4;4;
2018;2º;23367634;ZEMA ADMINISTRADORA DE CONSÓRCIO LTDA;Publicidade enganosa;0;0;3;3;
2018;2º;23367634;ZEMA ADMINISTRADORA DE CONSÓRCIO LTDA;Reclamações relacionadas a assuntos diversos;0;0;2;2;
2018;2º;23367634;ZEMA ADMINISTRADORA DE CONSÓRCIO LTDA;Recusa ou demora no fornecimento de documentos (exceto demonstrativos obrigatórios);0;0;4;4;
