Ano;Semestre;CNPJ AC;Administradora de consórcio;Irregularidade;Quantidade de reclamações reguladas procedentes;Quantidade de reclamações reguladas - outras;Quantidade de reclamações não reguladas;Quantidade total de reclamações;
2017;1º;84911098;ADEMILAR ADMINISTRADORA DE CONSORCIOS S.A.;Descumprimento de obrigações previstas em contratos;0;2;0;2;
2017;1º;06044551;ADMINISTRADORA DE CONSORCIO NACIONAL GAZIN LTDA;Ausência de transparência nas relações contratuais;0;0;1;1;
2017;1º;45441789;ADMINISTRADORA DE CONSORCIO NACIONAL HONDA LTDA;Ausência de transparência nas relações contratuais;0;0;8;8;
2017;1º;45441789;ADMINISTRADORA DE CONSORCIO NACIONAL HONDA LTDA;Descumprimento de cláusulas referentes à devolução de valores;2;35;0;37;
2017;1º;45441789;ADMINISTRADORA DE CONSORCIO NACIONAL HONDA LTDA;Descumprimento de obrigações previstas em contratos;3;8;0;11;
2017;1º;45441789;ADMINISTRADORA DE CONSORCIO NACIONAL HONDA LTDA;Descumprimento de prazo de resposta a demanda;2;0;0;2;
2017;1º;45441789;ADMINISTRADORA DE CONSORCIO NACIONAL HONDA LTDA;Dificuldade na liberação ou substituição de bem;0;0;4;4;
2017;1º;45441789;ADMINISTRADORA DE CONSORCIO NACIONAL HONDA LTDA;Insatisfação com a resposta fornecida pela administradora de consórcio relativa à demanda registrada contra ela;2;6;0;8;
2017;1º;45441789;ADMINISTRADORA DE CONSORCIO NACIONAL HONDA LTDA;Insatisfação por parte do cliente com o atendimento prestado pela administradora de consórcio;0;0;15;15;
2017;1º;45441789;ADMINISTRADORA DE CONSORCIO NACIONAL HONDA LTDA;Irregularidades relacionadas à liberação do crédito;6;48;0;54;
2017;1º;45441789;ADMINISTRADORA DE CONSORCIO NACIONAL HONDA LTDA;Irregularidades relacionadas às condições para contemplação por lance ou sorteio;0;4;0;4;
2017;1º;45441789;ADMINISTRADORA DE CONSORCIO NACIONAL HONDA LTDA;Não fornecimento, remessa ou divulgação de documentos obrigatórios;0;1;0;1;
2017;1º;45441789;ADMINISTRADORA DE CONSORCIO NACIONAL HONDA LTDA;Outras irregularidades relacionadas à Ouvidoria;0;1;0;1;
2017;1º;45441789;ADMINISTRADORA DE CONSORCIO NACIONAL HONDA LTDA;Prestação inadequada/insuficiente de informação;0;0;10;10;
2017;1º;45441789;ADMINISTRADORA DE CONSORCIO NACIONAL HONDA LTDA;Publicidade enganosa;0;0;1;1;
2017;1º;45441789;ADMINISTRADORA DE CONSORCIO NACIONAL HONDA LTDA;Reclamações relacionadas a assuntos diversos;0;0;19;19;
2017;1º;45441789;ADMINISTRADORA DE CONSORCIO NACIONAL HONDA LTDA;Recusa ou demora no fornecimento de documentos (exceto demonstrativos obrigatórios);0;0;7;7;
2017;1º;07808907;ADMINISTRADORA DE CONSORCIOS SICREDI LTDA;Descumprimento de obrigações previstas em contratos;1;0;0;1;
2017;1º;07808907;ADMINISTRADORA DE CONSORCIOS SICREDI LTDA;Insatisfação por parte do cliente com o atendimento prestado pela administradora de consórcio;0;0;1;1;
2017;1º;07808907;ADMINISTRADORA DE CONSORCIOS SICREDI LTDA;Irregularidades relacionadas à liberação do crédito;0;2;0;2;
2017;1º;07808907;ADMINISTRADORA DE CONSORCIOS SICREDI LTDA;Recusa ou demora no fornecimento de documentos (exceto demonstrativos obrigatórios);0;0;1;1;
2017;1º;30412977;ADMINISTRADORA DE CONSÓRCIO NACIONAL LÍDER LTDA.;Recusa ou demora no fornecimento de documentos (exceto demonstrativos obrigatórios);0;0;1;1;
2017;1º;73230674;ADMINISTRADORA DE CONSÓRCIO RCI BRASIL LTDA;Ausência de transparência nas relações contratuais;0;0;1;1;
2017;1º;73230674;ADMINISTRADORA DE CONSÓRCIO RCI BRASIL LTDA;Descumprimento de cláusulas referentes à devolução de valores;0;2;0;2;
2017;1º;73230674;ADMINISTRADORA DE CONSÓRCIO RCI BRASIL LTDA;Dificuldade na liberação ou substituição de bem;0;0;1;1;
2017;1º;73230674;ADMINISTRADORA DE CONSÓRCIO RCI BRASIL LTDA;Insatisfação por parte do cliente com o atendimento prestado pela administradora de consórcio;0;0;4;4;
2017;1º;73230674;ADMINISTRADORA DE CONSÓRCIO RCI BRASIL LTDA;Irregularidades relacionadas às condições para contemplação por lance ou sorteio;0;1;0;1;
2017;1º;73230674;ADMINISTRADORA DE CONSÓRCIO RCI BRASIL LTDA;Prestação inadequada/insuficiente de informação;0;0;1;1;
2017;1º;73230674;ADMINISTRADORA DE CONSÓRCIO RCI BRASIL LTDA;Reclamações relacionadas a assuntos diversos;0;0;3;3;
2017;1º;12228808;ADMINISTRADORA DE CONSÓRCIO SICOOB PARANÁ LTDA.;Ausência de informações/cláusulas obrigatórias em contrato;0;1;0;1;
2017;1º;12228808;ADMINISTRADORA DE CONSÓRCIO SICOOB PARANÁ LTDA.;Insatisfação por parte do cliente com o atendimento prestado pela administradora de consórcio;0;0;1;1;
2017;1º;12228808;ADMINISTRADORA DE CONSÓRCIO SICOOB PARANÁ LTDA.;Reclamações relacionadas a assuntos diversos;0;0;1;1;
2017;1º;91341925;ADMINISTRADORA DE CONSÓRCIO SPENGLER LTDA.;Insatisfação com a resposta fornecida pela administradora de consórcio relativa à demanda registrada contra ela;0;3;0;3;
2017;1º;91341925;ADMINISTRADORA DE CONSÓRCIO SPENGLER LTDA.;Outras irregularidades;1;0;0;1;
2017;1º;91341925;ADMINISTRADORA DE CONSÓRCIO SPENGLER LTDA.;Prestação inadequada/insuficiente de informação;0;0;1;1;
2017;1º;91341925;ADMINISTRADORA DE CONSÓRCIO SPENGLER LTDA.;Recusa ou demora no fornecimento de documentos (exceto demonstrativos obrigatórios);0;0;3;3;
2017;1º;03828278;ADMINISTRADORA DE CONSÓRCIOS BECKER LTDA.;Descumprimento de cláusulas referentes à devolução de valores;1;1;0;2;
2017;1º;94187879;AGIPLAN ADMINISTRADORA DE CONSÓRCIOS S.A.;Ausência de transparência nas relações contratuais;0;0;1;1;
2017;1º;94187879;AGIPLAN ADMINISTRADORA DE CONSÓRCIOS S.A.;Irregularidades relacionadas à liberação do crédito;0;1;0;1;
2017;1º;94187879;AGIPLAN ADMINISTRADORA DE CONSÓRCIOS S.A.;Irregularidades relacionadas às condições para contemplação por lance ou sorteio;0;1;0;1;
2017;1º;60375243;ANCORA ADMINISTRADORA DE CONSORCIOS S.A.;Descumprimento de cláusulas referentes à devolução de valores;0;4;0;4;
2017;1º;60375243;ANCORA ADMINISTRADORA DE CONSORCIOS S.A.;Descumprimento de prazo de resposta a demanda;1;0;0;1;
2017;1º;60375243;ANCORA ADMINISTRADORA DE CONSORCIOS S.A.;Prestação inadequada/insuficiente de informação;0;0;2;2;
2017;1º;13548938;ASSOCIACAO BAHIANA DE MEDICINA ABM;Insatisfação por parte do cliente com o atendimento prestado pela administradora de consórcio;0;0;1;1;
2017;1º;02010478;BANCORBRÁS ADMINISTRADORA DE CONSÓRCIOS S.A.;Descumprimento de cláusulas referentes à devolução de valores;0;2;0;2;
2017;1º;02010478;BANCORBRÁS ADMINISTRADORA DE CONSÓRCIOS S.A.;Outras irregularidades;1;0;0;1;
2017;1º;02010478;BANCORBRÁS ADMINISTRADORA DE CONSÓRCIOS S.A.;Prestação inadequada/insuficiente de informação;0;0;6;6;
2017;1º;92692979;BANRISUL S.A. - ADMINISTRADORA DE CONSÓRCIOS;Dificuldade na liberação ou substituição de bem;0;0;4;4;
2017;1º;92692979;BANRISUL S.A. - ADMINISTRADORA DE CONSÓRCIOS;Insatisfação com a resposta fornecida pela administradora de consórcio relativa à demanda registrada contra ela;0;1;0;1;
2017;1º;92692979;BANRISUL S.A. - ADMINISTRADORA DE CONSÓRCIOS;Irregularidades relacionadas à liberação do crédito;0;4;0;4;
2017;1º;92692979;BANRISUL S.A. - ADMINISTRADORA DE CONSÓRCIOS;Reclamações relacionadas a assuntos diversos;0;0;1;1;
2017;1º;45030236;BAURU ADMINISTRADORA DE CONSÓRCIOS LTDA;Descumprimento de cláusulas referentes à devolução de valores;0;1;0;1;
2017;1º;06043050;BB ADMINISTRADORA DE CONSORCIOS S.A.;Ausência de informações/cláusulas obrigatórias em contrato;0;1;0;1;
2017;1º;06043050;BB ADMINISTRADORA DE CONSORCIOS S.A.;Ausência de transparência nas relações contratuais;0;0;12;12;
2017;1º;06043050;BB ADMINISTRADORA DE CONSORCIOS S.A.;Descumprimento de cláusulas referentes à devolução de valores;1;25;0;26;
2017;1º;06043050;BB ADMINISTRADORA DE CONSORCIOS S.A.;Descumprimento de obrigações previstas em contratos;3;15;0;18;
2017;1º;06043050;BB ADMINISTRADORA DE CONSORCIOS S.A.;Descumprimento de prazo de resposta a demanda;1;8;0;9;
2017;1º;06043050;BB ADMINISTRADORA DE CONSORCIOS S.A.;Dificuldade na liberação ou substituição de bem;0;0;15;15;
2017;1º;06043050;BB ADMINISTRADORA DE CONSORCIOS S.A.;Insatisfação com a resposta fornecida pela administradora de consórcio relativa à demanda registrada contra ela;1;13;0;14;
2017;1º;06043050;BB ADMINISTRADORA DE CONSORCIOS S.A.;Insatisfação por parte do cliente com o atendimento prestado pela administradora de consórcio;0;0;20;20;
2017;1º;06043050;BB ADMINISTRADORA DE CONSORCIOS S.A.;Irregularidades relacionadas à liberação do crédito;11;47;0;58;
2017;1º;06043050;BB ADMINISTRADORA DE CONSORCIOS S.A.;Irregularidades relacionadas às condições para contemplação por lance ou sorteio;2;4;0;6;
2017;1º;06043050;BB ADMINISTRADORA DE CONSORCIOS S.A.;Outras irregularidades;0;1;0;1;
2017;1º;06043050;BB ADMINISTRADORA DE CONSORCIOS S.A.;Prestação inadequada/insuficiente de informação;0;0;22;22;
2017;1º;06043050;BB ADMINISTRADORA DE CONSORCIOS S.A.;Publicidade enganosa;0;0;4;4;
2017;1º;06043050;BB ADMINISTRADORA DE CONSORCIOS S.A.;Reclamações relacionadas a assuntos diversos;0;0;21;21;
2017;1º;06043050;BB ADMINISTRADORA DE CONSORCIOS S.A.;Recusa ou demora no fornecimento de documentos (exceto demonstrativos obrigatórios);0;0;20;20;
2017;1º;14723388;BR CONSÓRCIOS ADMINISTRADORA DE CONSÓRCIOS LTDA;Ausência de transparência nas relações contratuais;0;0;2;2;
2017;1º;14723388;BR CONSÓRCIOS ADMINISTRADORA DE CONSÓRCIOS LTDA;Descumprimento de cláusulas referentes à devolução de valores;1;2;0;3;
2017;1º;14723388;BR CONSÓRCIOS ADMINISTRADORA DE CONSÓRCIOS LTDA;Descumprimento de prazo de resposta a demanda;1;0;0;1;
2017;1º;14723388;BR CONSÓRCIOS ADMINISTRADORA DE CONSÓRCIOS LTDA;Dificuldade na liberação ou substituição de bem;0;0;1;1;
2017;1º;14723388;BR CONSÓRCIOS ADMINISTRADORA DE CONSÓRCIOS LTDA;Insatisfação com a resposta fornecida pela administradora de consórcio relativa à demanda registrada contra ela;0;3;0;3;
2017;1º;14723388;BR CONSÓRCIOS ADMINISTRADORA DE CONSÓRCIOS LTDA;Insatisfação por parte do cliente com o atendimento prestado pela administradora de consórcio;0;0;3;3;
2017;1º;14723388;BR CONSÓRCIOS ADMINISTRADORA DE CONSÓRCIOS LTDA;Irregularidades relacionadas à liberação do crédito;1;2;0;3;
2017;1º;14723388;BR CONSÓRCIOS ADMINISTRADORA DE CONSÓRCIOS LTDA;Irregularidades relacionadas às condições para contemplação por lance ou sorteio;0;2;0;2;
2017;1º;14723388;BR CONSÓRCIOS ADMINISTRADORA DE CONSÓRCIOS LTDA;Prestação inadequada/insuficiente de informação;0;0;5;5;
2017;1º;14723388;BR CONSÓRCIOS ADMINISTRADORA DE CONSÓRCIOS LTDA;Reclamações relacionadas a assuntos diversos;0;0;3;3;
2017;1º;14723388;BR CONSÓRCIOS ADMINISTRADORA DE CONSÓRCIOS LTDA;Recusa ou demora no fornecimento de documentos (exceto demonstrativos obrigatórios);0;0;2;2;
2017;1º;52568821;BRADESCO ADMINISTRADORA DE CONSÓRCIOS LTDA.;Ausência de transparência nas relações contratuais;0;0;6;6;
2017;1º;52568821;BRADESCO ADMINISTRADORA DE CONSÓRCIOS LTDA.;Cobrança irregular de tarifa pela emissão de boletos, carnês e assemelhados;0;8;0;8;
2017;1º;52568821;BRADESCO ADMINISTRADORA DE CONSÓRCIOS LTDA.;Descumprimento de cláusulas referentes à devolução de valores;2;76;0;78;
2017;1º;52568821;BRADESCO ADMINISTRADORA DE CONSÓRCIOS LTDA.;Descumprimento de obrigações previstas em contratos;11;82;0;93;
2017;1º;52568821;BRADESCO ADMINISTRADORA DE CONSÓRCIOS LTDA.;Descumprimento de prazo de resposta a demanda;0;17;0;17;
2017;1º;52568821;BRADESCO ADMINISTRADORA DE CONSÓRCIOS LTDA.;Descumprimento de prazo para apresentação de resposta conclusiva pela Ouvidoria;0;5;0;5;
2017;1º;52568821;BRADESCO ADMINISTRADORA DE CONSÓRCIOS LTDA.;Dificuldade na liberação ou substituição de bem;0;0;91;91;
2017;1º;52568821;BRADESCO ADMINISTRADORA DE CONSÓRCIOS LTDA.;Insatisfação com a resposta fornecida pela administradora de consórcio relativa à demanda registrada contra ela;7;30;0;37;
2017;1º;52568821;BRADESCO ADMINISTRADORA DE CONSÓRCIOS LTDA.;Insatisfação por parte do cliente com o atendimento prestado pela administradora de consórcio;0;0;77;77;
2017;1º;52568821;BRADESCO ADMINISTRADORA DE CONSÓRCIOS LTDA.;Irregularidades relacionadas à liberação do crédito;2;185;0;187;
2017;1º;52568821;BRADESCO ADMINISTRADORA DE CONSÓRCIOS LTDA.;Irregularidades relacionadas às condições para contemplação por lance ou sorteio;0;9;0;9;
2017;1º;52568821;BRADESCO ADMINISTRADORA DE CONSÓRCIOS LTDA.;Não fornecimento, remessa ou divulgação de documentos obrigatórios;0;1;0;1;
2017;1º;52568821;BRADESCO ADMINISTRADORA DE CONSÓRCIOS LTDA.;Outras irregularidades;0;3;0;3;
2017;1º;52568821;BRADESCO ADMINISTRADORA DE CONSÓRCIOS LTDA.;Outras irregularidades relacionadas à Ouvidoria;0;1;0;1;
2017;1º;52568821;BRADESCO ADMINISTRADORA DE CONSÓRCIOS LTDA.;Prestação inadequada/insuficiente de informação;0;0;147;147;
2017;1º;52568821;BRADESCO ADMINISTRADORA DE CONSÓRCIOS LTDA.;Publicidade enganosa;0;0;3;3;
2017;1º;52568821;BRADESCO ADMINISTRADORA DE CONSÓRCIOS LTDA.;Reclamações relacionadas a assuntos diversos;0;0;46;46;
2017;1º;52568821;BRADESCO ADMINISTRADORA DE CONSÓRCIOS LTDA.;Recusa ou demora no fornecimento de documentos (exceto demonstrativos obrigatórios);0;0;30;30;
2017;1º;73235962;BREITKOPF ADMINISTRADORA DE CONSÓRCIO LTDA.;Insatisfação por parte do cliente com o atendimento prestado pela administradora de consórcio;0;0;1;1;
2017;1º;73235962;BREITKOPF ADMINISTRADORA DE CONSÓRCIO LTDA.;Irregularidades relacionadas à liberação do crédito;0;1;0;1;
2017;1º;73235962;BREITKOPF ADMINISTRADORA DE CONSÓRCIO LTDA.;Outras irregularidades;1;0;0;1;
2017;1º;73235962;BREITKOPF ADMINISTRADORA DE CONSÓRCIO LTDA.;Prestação inadequada/insuficiente de informação;0;0;1;1;
2017;1º;45713971;BRQUALY ADMINISTRADORA DE CONSÓRCIOS LTDA.;Irregularidades relacionadas às condições para contemplação por lance ou sorteio;0;1;0;1;
2017;1º;05349595;CAIXA CONSÓRCIOS S.A ADMINISTRADORA DE CONSÓRCIOS;Ausência de informações/cláusulas obrigatórias em contrato;1;0;0;1;
2017;1º;05349595;CAIXA CONSÓRCIOS S.A ADMINISTRADORA DE CONSÓRCIOS;Ausência de transparência nas relações contratuais;0;0;2;2;
2017;1º;05349595;CAIXA CONSÓRCIOS S.A ADMINISTRADORA DE CONSÓRCIOS;Cobrança irregular de tarifa pela emissão de boletos, carnês e assemelhados;0;1;0;1;
2017;1º;05349595;CAIXA CONSÓRCIOS S.A ADMINISTRADORA DE CONSÓRCIOS;Descumprimento de cláusulas referentes à devolução de valores;5;15;0;20;
2017;1º;05349595;CAIXA CONSÓRCIOS S.A ADMINISTRADORA DE CONSÓRCIOS;Descumprimento de obrigações previstas em contratos;7;15;0;22;
2017;1º;05349595;CAIXA CONSÓRCIOS S.A ADMINISTRADORA DE CONSÓRCIOS;Descumprimento de prazo de resposta a demanda;1;3;0;4;
2017;1º;05349595;CAIXA CONSÓRCIOS S.A ADMINISTRADORA DE CONSÓRCIOS;Dificuldade na liberação ou substituição de bem;0;0;8;8;
2017;1º;05349595;CAIXA CONSÓRCIOS S.A ADMINISTRADORA DE CONSÓRCIOS;Insatisfação com a resposta fornecida pela administradora de consórcio relativa à demanda registrada contra ela;1;15;0;16;
2017;1º;05349595;CAIXA CONSÓRCIOS S.A ADMINISTRADORA DE CONSÓRCIOS;Insatisfação por parte do cliente com o atendimento prestado pela administradora de consórcio;0;0;27;27;
2017;1º;05349595;CAIXA CONSÓRCIOS S.A ADMINISTRADORA DE CONSÓRCIOS;Irregularidades relacionadas à liberação do crédito;8;53;0;61;
2017;1º;05349595;CAIXA CONSÓRCIOS S.A ADMINISTRADORA DE CONSÓRCIOS;Irregularidades relacionadas às condições para contemplação por lance ou sorteio;0;9;0;9;
2017;1º;05349595;CAIXA CONSÓRCIOS S.A ADMINISTRADORA DE CONSÓRCIOS;Outras irregularidades;1;5;0;6;
2017;1º;05349595;CAIXA CONSÓRCIOS S.A ADMINISTRADORA DE CONSÓRCIOS;Outras irregularidades relacionadas à Ouvidoria;0;1;0;1;
2017;1º;05349595;CAIXA CONSÓRCIOS S.A ADMINISTRADORA DE CONSÓRCIOS;Prestação inadequada/insuficiente de informação;0;0;3;3;
2017;1º;05349595;CAIXA CONSÓRCIOS S.A ADMINISTRADORA DE CONSÓRCIOS;Publicidade enganosa;0;0;1;1;
2017;1º;05349595;CAIXA CONSÓRCIOS S.A ADMINISTRADORA DE CONSÓRCIOS;Reclamações relacionadas a assuntos diversos;0;0;30;30;
2017;1º;05349595;CAIXA CONSÓRCIOS S.A ADMINISTRADORA DE CONSÓRCIOS;Recusa ou demora no fornecimento de documentos (exceto demonstrativos obrigatórios);0;0;3;3;
2017;1º;68318773;CANOPUS ADMINISTRADORA DE CONSORCIOS S/A;Ausência de transparência nas relações contratuais;0;0;1;1;
2017;1º;68318773;CANOPUS ADMINISTRADORA DE CONSORCIOS S/A;Descumprimento de obrigações previstas em contratos;0;2;0;2;
2017;1º;68318773;CANOPUS ADMINISTRADORA DE CONSORCIOS S/A;Insatisfação com a resposta fornecida pela administradora de consórcio relativa à demanda registrada contra ela;0;1;0;1;
2017;1º;68318773;CANOPUS ADMINISTRADORA DE CONSORCIOS S/A;Insatisfação por parte do cliente com o atendimento prestado pela administradora de consórcio;0;0;1;1;
2017;1º;68318773;CANOPUS ADMINISTRADORA DE CONSORCIOS S/A;Irregularidades relacionadas à liberação do crédito;0;1;0;1;
2017;1º;68318773;CANOPUS ADMINISTRADORA DE CONSORCIOS S/A;Outras irregularidades;0;2;0;2;
2017;1º;68318773;CANOPUS ADMINISTRADORA DE CONSORCIOS S/A;Publicidade enganosa;0;0;1;1;
2017;1º;68318773;CANOPUS ADMINISTRADORA DE CONSORCIOS S/A;Reclamações relacionadas a assuntos diversos;0;0;1;1;
2017;1º;00266031;CICAL ADMINISTRADORA DE CONSÓRCIOS LTDA;Prestação inadequada/insuficiente de informação;0;0;1;1;
2017;1º;13170428;CIMAVEL ADMINISTRADORA DE CONSÓRCIO LTDA.;Recusa ou demora no fornecimento de documentos (exceto demonstrativos obrigatórios);0;0;1;1;
2017;1º;59129403;CNF - ADMINISTRADORA DE CONSÓRCIOS NACIONAL LTDA.;Ausência de transparência nas relações contratuais;0;0;1;1;
2017;1º;59129403;CNF - ADMINISTRADORA DE CONSÓRCIOS NACIONAL LTDA.;Descumprimento de cláusulas referentes à devolução de valores;0;3;0;3;
2017;1º;59129403;CNF - ADMINISTRADORA DE CONSÓRCIOS NACIONAL LTDA.;Descumprimento de obrigações previstas em contratos;0;2;0;2;
2017;1º;59129403;CNF - ADMINISTRADORA DE CONSÓRCIOS NACIONAL LTDA.;Insatisfação por parte do cliente com o atendimento prestado pela administradora de consórcio;0;0;2;2;
2017;1º;59129403;CNF - ADMINISTRADORA DE CONSÓRCIOS NACIONAL LTDA.;Irregularidades relacionadas à liberação do crédito;0;1;0;1;
2017;1º;59129403;CNF - ADMINISTRADORA DE CONSÓRCIOS NACIONAL LTDA.;Publicidade enganosa;0;0;1;1;
2017;1º;59129403;CNF - ADMINISTRADORA DE CONSÓRCIOS NACIONAL LTDA.;Recusa ou demora no fornecimento de documentos (exceto demonstrativos obrigatórios);0;0;1;1;
2017;1º;62798475;CNK ADMINISTRADORA DE CONSÓRCIO LTDA.;Descumprimento de cláusulas referentes à devolução de valores;0;1;0;1;
2017;1º;44474674;COMAUTO ADMINISTRADORA DE CONSORCIO LTDA;Ausência de transparência nas relações contratuais;0;0;1;1;
2017;1º;07336852;CONBRAV - ADMINISTRADORA DE CONSÓRCIOS LTDA.;Insatisfação por parte do cliente com o atendimento prestado pela administradora de consórcio;0;0;1;1;
2017;1º;50827237;CONFIA ADMINISTRADORA DE CONSÓRCIO LTDA.;Irregularidades relacionadas à liberação do crédito;0;1;0;1;
2017;1º;81742223;CONSEG ADMINISTRADORA DE CONSORCIOS LTDA.;Ausência de transparência nas relações contratuais;0;0;1;1;
2017;1º;81742223;CONSEG ADMINISTRADORA DE CONSORCIOS LTDA.;Descumprimento de cláusulas referentes à devolução de valores;0;2;0;2;
2017;1º;81742223;CONSEG ADMINISTRADORA DE CONSORCIOS LTDA.;Irregularidades relacionadas às condições para contemplação por lance ou sorteio;0;2;0;2;
2017;1º;81742223;CONSEG ADMINISTRADORA DE CONSORCIOS LTDA.;Reclamações relacionadas a assuntos diversos;0;0;1;1;
2017;1º;44196293;CONSHOP ADMINISTRADORA DE CONSORCIOS LTDA.;Irregularidades relacionadas às condições para contemplação por lance ou sorteio;0;2;0;2;
2017;1º;47658539;CONSÓRCIO NACIONAL VOLKSWAGEN - ADMINISTRADORA DE CONSÓRCIO LTDA.;Ausência de informações/cláusulas obrigatórias em contrato;0;1;0;1;
2017;1º;47658539;CONSÓRCIO NACIONAL VOLKSWAGEN - ADMINISTRADORA DE CONSÓRCIO LTDA.;Ausência de transparência nas relações contratuais;0;0;12;12;
2017;1º;47658539;CONSÓRCIO NACIONAL VOLKSWAGEN - ADMINISTRADORA DE CONSÓRCIO LTDA.;Descumprimento de cláusulas referentes à devolução de valores;3;38;0;41;
2017;1º;47658539;CONSÓRCIO NACIONAL VOLKSWAGEN - ADMINISTRADORA DE CONSÓRCIO LTDA.;Descumprimento de obrigações previstas em contratos;1;10;0;11;
2017;1º;47658539;CONSÓRCIO NACIONAL VOLKSWAGEN - ADMINISTRADORA DE CONSÓRCIO LTDA.;Descumprimento de prazo de resposta a demanda;1;1;0;2;
2017;1º;47658539;CONSÓRCIO NACIONAL VOLKSWAGEN - ADMINISTRADORA DE CONSÓRCIO LTDA.;Descumprimento de prazo para apresentação de resposta conclusiva pela Ouvidoria;0;1;0;1;
2017;1º;47658539;CONSÓRCIO NACIONAL VOLKSWAGEN - ADMINISTRADORA DE CONSÓRCIO LTDA.;Dificuldade na liberação ou substituição de bem;0;0;10;10;
2017;1º;47658539;CONSÓRCIO NACIONAL VOLKSWAGEN - ADMINISTRADORA DE CONSÓRCIO LTDA.;Insatisfação com a resposta fornecida pela administradora de consórcio relativa à demanda registrada contra ela;0;10;0;10;
2017;1º;47658539;CONSÓRCIO NACIONAL VOLKSWAGEN - ADMINISTRADORA DE CONSÓRCIO LTDA.;Insatisfação por parte do cliente com o atendimento prestado pela administradora de consórcio;0;0;21;21;
2017;1º;47658539;CONSÓRCIO NACIONAL VOLKSWAGEN - ADMINISTRADORA DE CONSÓRCIO LTDA.;Irregularidades relacionadas à liberação do crédito;5;34;0;39;
2017;1º;47658539;CONSÓRCIO NACIONAL VOLKSWAGEN - ADMINISTRADORA DE CONSÓRCIO LTDA.;Irregularidades relacionadas às condições para contemplação por lance ou sorteio;0;9;0;9;
2017;1º;47658539;CONSÓRCIO NACIONAL VOLKSWAGEN - ADMINISTRADORA DE CONSÓRCIO LTDA.;Outras irregularidades relacionadas à Ouvidoria;0;1;0;1;
2017;1º;47658539;CONSÓRCIO NACIONAL VOLKSWAGEN - ADMINISTRADORA DE CONSÓRCIO LTDA.;Prestação inadequada/insuficiente de informação;0;0;13;13;
2017;1º;47658539;CONSÓRCIO NACIONAL VOLKSWAGEN - ADMINISTRADORA DE CONSÓRCIO LTDA.;Publicidade enganosa;0;0;1;1;
2017;1º;47658539;CONSÓRCIO NACIONAL VOLKSWAGEN - ADMINISTRADORA DE CONSÓRCIO LTDA.;Reclamações relacionadas a assuntos diversos;0;0;15;15;
2017;1º;47658539;CONSÓRCIO NACIONAL VOLKSWAGEN - ADMINISTRADORA DE CONSÓRCIO LTDA.;Recusa ou demora no fornecimento de documentos (exceto demonstrativos obrigatórios);0;0;17;17;
2017;1º;27440684;CONTAUTO ADMINISTRADORA DE CONSÓRCIOS LTDA.;Dificuldade na liberação ou substituição de bem;0;0;1;1;
2017;1º;58919903;CONVEF ADMINISTRADORA DE CONSÓRCIOS LTDA.;Descumprimento de cláusulas referentes à devolução de valores;0;5;0;5;
2017;1º;58919903;CONVEF ADMINISTRADORA DE CONSÓRCIOS LTDA.;Insatisfação com a resposta fornecida pela administradora de consórcio relativa à demanda registrada contra ela;1;0;0;1;
2017;1º;58919903;CONVEF ADMINISTRADORA DE CONSÓRCIOS LTDA.;Insatisfação por parte do cliente com o atendimento prestado pela administradora de consórcio;0;0;1;1;
2017;1º;58919903;CONVEF ADMINISTRADORA DE CONSÓRCIOS LTDA.;Outras irregularidades;1;0;0;1;
2017;1º;58919903;CONVEF ADMINISTRADORA DE CONSÓRCIOS LTDA.;Reclamações relacionadas a assuntos diversos;0;0;1;1;
2017;1º;59395061;DISAL ADMINISTRADORA DE CONSÓRCIOS LTDA;Ausência de transparência nas relações contratuais;0;0;2;2;
2017;1º;59395061;DISAL ADMINISTRADORA DE CONSÓRCIOS LTDA;Descumprimento de cláusulas referentes à devolução de valores;0;9;0;9;
2017;1º;59395061;DISAL ADMINISTRADORA DE CONSÓRCIOS LTDA;Descumprimento de obrigações previstas em contratos;0;13;0;13;
2017;1º;59395061;DISAL ADMINISTRADORA DE CONSÓRCIOS LTDA;Descumprimento de prazo de resposta a demanda;0;1;0;1;
2017;1º;59395061;DISAL ADMINISTRADORA DE CONSÓRCIOS LTDA;Dificuldade na liberação ou substituição de bem;0;0;1;1;
2017;1º;59395061;DISAL ADMINISTRADORA DE CONSÓRCIOS LTDA;Insatisfação com a resposta fornecida pela administradora de consórcio relativa à demanda registrada contra ela;0;5;0;5;
2017;1º;59395061;DISAL ADMINISTRADORA DE CONSÓRCIOS LTDA;Insatisfação por parte do cliente com o atendimento prestado pela administradora de consórcio;0;0;6;6;
2017;1º;59395061;DISAL ADMINISTRADORA DE CONSÓRCIOS LTDA;Irregularidades relacionadas à liberação do crédito;1;26;0;27;
2017;1º;59395061;DISAL ADMINISTRADORA DE CONSÓRCIOS LTDA;Irregularidades relacionadas às condições para contemplação por lance ou sorteio;1;2;0;3;
2017;1º;59395061;DISAL ADMINISTRADORA DE CONSÓRCIOS LTDA;Não fornecimento, remessa ou divulgação de documentos obrigatórios;1;0;0;1;
2017;1º;59395061;DISAL ADMINISTRADORA DE CONSÓRCIOS LTDA;Outras irregularidades;0;1;0;1;
2017;1º;59395061;DISAL ADMINISTRADORA DE CONSÓRCIOS LTDA;Prestação inadequada/insuficiente de informação;0;0;14;14;
2017;1º;59395061;DISAL ADMINISTRADORA DE CONSÓRCIOS LTDA;Publicidade enganosa;0;0;3;3;
2017;1º;59395061;DISAL ADMINISTRADORA DE CONSÓRCIOS LTDA;Reclamações relacionadas a assuntos diversos;0;0;8;8;
2017;1º;59395061;DISAL ADMINISTRADORA DE CONSÓRCIOS LTDA;Recusa ou demora no fornecimento de documentos (exceto demonstrativos obrigatórios);0;0;2;2;
2017;1º;08570707;ELDORADO ADMINISTRADORA DE CONSORCIO LTDA;Descumprimento de cláusulas referentes à devolução de valores;0;1;0;1;
2017;1º;58113812;EMBRACON ADMINISTRADORA DE CONSÓRCIO LTDA;Ausência de transparência nas relações contratuais;0;0;13;13;
2017;1º;58113812;EMBRACON ADMINISTRADORA DE CONSÓRCIO LTDA;Descumprimento de cláusulas referentes à devolução de valores;0;23;0;23;
2017;1º;58113812;EMBRACON ADMINISTRADORA DE CONSÓRCIO LTDA;Descumprimento de obrigações previstas em contratos;5;2;0;7;
2017;1º;58113812;EMBRACON ADMINISTRADORA DE CONSÓRCIO LTDA;Descumprimento de prazo de resposta a demanda;0;11;0;11;
2017;1º;58113812;EMBRACON ADMINISTRADORA DE CONSÓRCIO LTDA;Descumprimento de prazo para apresentação de resposta conclusiva pela Ouvidoria;3;0;0;3;
2017;1º;58113812;EMBRACON ADMINISTRADORA DE CONSÓRCIO LTDA;Dificuldade na liberação ou substituição de bem;0;0;2;2;
2017;1º;58113812;EMBRACON ADMINISTRADORA DE CONSÓRCIO LTDA;Insatisfação com a resposta fornecida pela administradora de consórcio relativa à demanda registrada contra ela;1;12;0;13;
2017;1º;58113812;EMBRACON ADMINISTRADORA DE CONSÓRCIO LTDA;Insatisfação por parte do cliente com o atendimento prestado pela administradora de consórcio;0;0;10;10;
2017;1º;58113812;EMBRACON ADMINISTRADORA DE CONSÓRCIO LTDA;Irregularidades relacionadas à liberação do crédito;1;23;0;24;
2017;1º;58113812;EMBRACON ADMINISTRADORA DE CONSÓRCIO LTDA;Irregularidades relacionadas às condições para contemplação por lance ou sorteio;0;7;0;7;
2017;1º;58113812;EMBRACON ADMINISTRADORA DE CONSÓRCIO LTDA;Outras irregularidades;5;9;0;14;
2017;1º;58113812;EMBRACON ADMINISTRADORA DE CONSÓRCIO LTDA;Outras irregularidades relacionadas à Ouvidoria;1;0;0;1;
2017;1º;58113812;EMBRACON ADMINISTRADORA DE CONSÓRCIO LTDA;Prestação inadequada/insuficiente de informação;0;0;91;91;
2017;1º;58113812;EMBRACON ADMINISTRADORA DE CONSÓRCIO LTDA;Publicidade enganosa;0;0;28;28;
2017;1º;58113812;EMBRACON ADMINISTRADORA DE CONSÓRCIO LTDA;Reclamações relacionadas a assuntos diversos;0;0;5;5;
2017;1º;58113812;EMBRACON ADMINISTRADORA DE CONSÓRCIO LTDA;Recusa ou demora no fornecimento de documentos (exceto demonstrativos obrigatórios);0;0;5;5;
2017;1º;91107581;FARROUPILHA ADMINISTRADORA DE CONSÓRCIOS LTDA.;Descumprimento de cláusulas referentes à devolução de valores;0;1;0;1;
2017;1º;91107581;FARROUPILHA ADMINISTRADORA DE CONSÓRCIOS LTDA.;Irregularidades relacionadas à liberação do crédito;0;1;0;1;
2017;1º;91107581;FARROUPILHA ADMINISTRADORA DE CONSÓRCIOS LTDA.;Prestação inadequada/insuficiente de informação;0;0;1;1;
2017;1º;91107581;FARROUPILHA ADMINISTRADORA DE CONSÓRCIOS LTDA.;Recusa ou demora no fornecimento de documentos (exceto demonstrativos obrigatórios);0;0;1;1;
2017;1º;00600262;FERRAZ ADMINISTRACAO E CONSORCIOS LTDA;Outras irregularidades;1;0;0;1;
2017;1º;45725975;FINAMA ADMINISTRADORA DE CONSORCIO LTDA;Insatisfação com a resposta fornecida pela administradora de consórcio relativa à demanda registrada contra ela;0;1;0;1;
2017;1º;45725975;FINAMA ADMINISTRADORA DE CONSORCIO LTDA;Irregularidades relacionadas às condições para contemplação por lance ou sorteio;0;1;0;1;
2017;1º;45725975;FINAMA ADMINISTRADORA DE CONSORCIO LTDA;Reclamações relacionadas a assuntos diversos;0;0;1;1;
2017;1º;00643742;FUNDACAO HABITACIONAL DO EXERCITO - FHE;Prestação inadequada/insuficiente de informação;0;0;1;1;
2017;1º;00643742;FUNDACAO HABITACIONAL DO EXERCITO - FHE;Reclamações relacionadas a assuntos diversos;0;0;1;1;
2017;1º;00643742;FUNDACAO HABITACIONAL DO EXERCITO - FHE;Recusa ou demora no fornecimento de documentos (exceto demonstrativos obrigatórios);0;0;1;1;
2017;1º;47820097;GAPLAN ADMINISTRADORA DE CONSÓRCIO LTDA.;Descumprimento de cláusulas referentes à devolução de valores;0;1;0;1;
2017;1º;47820097;GAPLAN ADMINISTRADORA DE CONSÓRCIO LTDA.;Irregularidades relacionadas à liberação do crédito;0;1;0;1;
2017;1º;47820097;GAPLAN ADMINISTRADORA DE CONSÓRCIO LTDA.;Recusa ou demora no fornecimento de documentos (exceto demonstrativos obrigatórios);0;0;1;1;
2017;1º;85322204;GLOBO ADMINISTRADORA DE CONSÓRCIOS LTDA.;Prestação inadequada/insuficiente de informação;0;0;1;1;
2017;1º;49937055;GMAC ADMINISTRADORA DE CONSORCIOS LTDA;Ausência de transparência nas relações contratuais;0;0;4;4;
2017;1º;49937055;GMAC ADMINISTRADORA DE CONSORCIOS LTDA;Descumprimento de cláusulas referentes à devolução de valores;1;7;0;8;
2017;1º;49937055;GMAC ADMINISTRADORA DE CONSORCIOS LTDA;Descumprimento de obrigações previstas em contratos;1;3;0;4;
2017;1º;49937055;GMAC ADMINISTRADORA DE CONSORCIOS LTDA;Descumprimento de prazo de resposta a demanda;0;1;0;1;
2017;1º;49937055;GMAC ADMINISTRADORA DE CONSORCIOS LTDA;Dificuldade na liberação ou substituição de bem;0;0;10;10;
2017;1º;49937055;GMAC ADMINISTRADORA DE CONSORCIOS LTDA;Insatisfação com a resposta fornecida pela administradora de consórcio relativa à demanda registrada contra ela;0;3;0;3;
2017;1º;49937055;GMAC ADMINISTRADORA DE CONSORCIOS LTDA;Insatisfação por parte do cliente com o atendimento prestado pela administradora de consórcio;0;0;13;13;
2017;1º;49937055;GMAC ADMINISTRADORA DE CONSORCIOS LTDA;Irregularidades relacionadas à liberação do crédito;3;30;0;33;
2017;1º;49937055;GMAC ADMINISTRADORA DE CONSORCIOS LTDA;Irregularidades relacionadas às condições para contemplação por lance ou sorteio;0;2;0;2;
2017;1º;49937055;GMAC ADMINISTRADORA DE CONSORCIOS LTDA;Prestação inadequada/insuficiente de informação;0;0;7;7;
2017;1º;49937055;GMAC ADMINISTRADORA DE CONSORCIOS LTDA;Reclamações relacionadas a assuntos diversos;0;0;9;9;
2017;1º;49937055;GMAC ADMINISTRADORA DE CONSORCIOS LTDA;Recusa ou demora no fornecimento de documentos (exceto demonstrativos obrigatórios);0;0;13;13;
2017;1º;03586655;H. ADMINISTRADORA DE CONSÓRCIOS LTDA;Insatisfação com a resposta fornecida pela administradora de consórcio relativa à demanda registrada contra ela;0;1;0;1;
2017;1º;73516106;HS ADMINISTRADORA DE CONSÓRCIOS LTDA;Descumprimento de cláusulas referentes à devolução de valores;0;2;0;2;
2017;1º;73516106;HS ADMINISTRADORA DE CONSÓRCIOS LTDA;Descumprimento de prazo de resposta a demanda;0;1;0;1;
2017;1º;73516106;HS ADMINISTRADORA DE CONSÓRCIOS LTDA;Insatisfação com a resposta fornecida pela administradora de consórcio relativa à demanda registrada contra ela;0;1;0;1;
2017;1º;73516106;HS ADMINISTRADORA DE CONSÓRCIOS LTDA;Insatisfação por parte do cliente com o atendimento prestado pela administradora de consórcio;0;0;1;1;
2017;1º;73516106;HS ADMINISTRADORA DE CONSÓRCIOS LTDA;Irregularidades relacionadas à liberação do crédito;0;4;0;4;
2017;1º;73516106;HS ADMINISTRADORA DE CONSÓRCIOS LTDA;Prestação inadequada/insuficiente de informação;0;0;5;5;
2017;1º;06181431;ITAUNA ADMINISTRADORA DE CONSORCIO LTDA;Insatisfação por parte do cliente com o atendimento prestado pela administradora de consórcio;0;0;1;1;
2017;1º;00000776;ITAÚ ADMINISTRADORA DE CONSÓRCIOS LTDA.;Ausência de transparência nas relações contratuais;0;0;6;6;
2017;1º;00000776;ITAÚ ADMINISTRADORA DE CONSÓRCIOS LTDA.;Cobrança irregular de tarifa pela emissão de boletos, carnês e assemelhados;0;1;0;1;
2017;1º;00000776;ITAÚ ADMINISTRADORA DE CONSÓRCIOS LTDA.;Descumprimento de cláusulas referentes à devolução de valores;4;48;0;52;
2017;1º;00000776;ITAÚ ADMINISTRADORA DE CONSÓRCIOS LTDA.;Descumprimento de obrigações previstas em contratos;1;14;0;15;
2017;1º;00000776;ITAÚ ADMINISTRADORA DE CONSÓRCIOS LTDA.;Descumprimento de prazo para apresentação de resposta conclusiva pela Ouvidoria;0;1;0;1;
2017;1º;00000776;ITAÚ ADMINISTRADORA DE CONSÓRCIOS LTDA.;Dificuldade na liberação ou substituição de bem;0;0;22;22;
2017;1º;00000776;ITAÚ ADMINISTRADORA DE CONSÓRCIOS LTDA.;Insatisfação com a resposta fornecida pela administradora de consórcio relativa à demanda registrada contra ela;4;9;0;13;
2017;1º;00000776;ITAÚ ADMINISTRADORA DE CONSÓRCIOS LTDA.;Insatisfação por parte do cliente com o atendimento prestado pela administradora de consórcio;0;0;14;14;
2017;1º;00000776;ITAÚ ADMINISTRADORA DE CONSÓRCIOS LTDA.;Irregularidades relacionadas à liberação do crédito;2;56;0;58;
2017;1º;00000776;ITAÚ ADMINISTRADORA DE CONSÓRCIOS LTDA.;Irregularidades relacionadas às condições para contemplação por lance ou sorteio;0;11;0;11;
2017;1º;00000776;ITAÚ ADMINISTRADORA DE CONSÓRCIOS LTDA.;Não fornecimento, remessa ou divulgação de documentos obrigatórios;2;0;0;2;
2017;1º;00000776;ITAÚ ADMINISTRADORA DE CONSÓRCIOS LTDA.;Outras irregularidades;0;3;0;3;
2017;1º;00000776;ITAÚ ADMINISTRADORA DE CONSÓRCIOS LTDA.;Prestação inadequada/insuficiente de informação;0;0;21;21;
2017;1º;00000776;ITAÚ ADMINISTRADORA DE CONSÓRCIOS LTDA.;Publicidade enganosa;0;0;6;6;
2017;1º;00000776;ITAÚ ADMINISTRADORA DE CONSÓRCIOS LTDA.;Reclamações relacionadas a assuntos diversos;0;0;67;67;
2017;1º;00000776;ITAÚ ADMINISTRADORA DE CONSÓRCIOS LTDA.;Recusa ou demora no fornecimento de documentos (exceto demonstrativos obrigatórios);0;0;12;12;
2017;1º;42421776;ITAÚ UNIBANCO VEÍCULOS ADMINISTRADORA DE CONSÓRCIOS LTDA.;Ausência de transparência nas relações contratuais;0;0;3;3;
2017;1º;42421776;ITAÚ UNIBANCO VEÍCULOS ADMINISTRADORA DE CONSÓRCIOS LTDA.;Descumprimento de cláusulas referentes à devolução de valores;0;8;0;8;
2017;1º;42421776;ITAÚ UNIBANCO VEÍCULOS ADMINISTRADORA DE CONSÓRCIOS LTDA.;Descumprimento de obrigações previstas em contratos;2;6;0;8;
2017;1º;42421776;ITAÚ UNIBANCO VEÍCULOS ADMINISTRADORA DE CONSÓRCIOS LTDA.;Descumprimento de prazo de resposta a demanda;0;1;0;1;
2017;1º;42421776;ITAÚ UNIBANCO VEÍCULOS ADMINISTRADORA DE CONSÓRCIOS LTDA.;Dificuldade na liberação ou substituição de bem;0;0;3;3;
2017;1º;42421776;ITAÚ UNIBANCO VEÍCULOS ADMINISTRADORA DE CONSÓRCIOS LTDA.;Insatisfação com a resposta fornecida pela administradora de consórcio relativa à demanda registrada contra ela;0;1;0;1;
2017;1º;42421776;ITAÚ UNIBANCO VEÍCULOS ADMINISTRADORA DE CONSÓRCIOS LTDA.;Insatisfação por parte do cliente com o atendimento prestado pela administradora de consórcio;0;0;8;8;
2017;1º;42421776;ITAÚ UNIBANCO VEÍCULOS ADMINISTRADORA DE CONSÓRCIOS LTDA.;Irregularidades relacionadas à liberação do crédito;1;15;0;16;
2017;1º;42421776;ITAÚ UNIBANCO VEÍCULOS ADMINISTRADORA DE CONSÓRCIOS LTDA.;Irregularidades relacionadas às condições para contemplação por lance ou sorteio;0;1;0;1;
2017;1º;42421776;ITAÚ UNIBANCO VEÍCULOS ADMINISTRADORA DE CONSÓRCIOS LTDA.;Outras irregularidades;0;1;0;1;
2017;1º;42421776;ITAÚ UNIBANCO VEÍCULOS ADMINISTRADORA DE CONSÓRCIOS LTDA.;Prestação inadequada/insuficiente de informação;0;0;3;3;
2017;1º;42421776;ITAÚ UNIBANCO VEÍCULOS ADMINISTRADORA DE CONSÓRCIOS LTDA.;Reclamações relacionadas a assuntos diversos;0;0;12;12;
2017;1º;42421776;ITAÚ UNIBANCO VEÍCULOS ADMINISTRADORA DE CONSÓRCIOS LTDA.;Recusa ou demora no fornecimento de documentos (exceto demonstrativos obrigatórios);0;0;2;2;
2017;1º;37137767;JORLAN ADMINISTRADORA DE CONSÓRCIO LTDA.;Descumprimento de cláusulas referentes à devolução de valores;0;1;0;1;
2017;1º;60250776;LUIZA ADMINISTRADORA DE CONSÓRCIOS LTDA;Descumprimento de cláusulas referentes à devolução de valores;0;5;0;5;
2017;1º;60250776;LUIZA ADMINISTRADORA DE CONSÓRCIOS LTDA;Descumprimento de obrigações previstas em contratos;0;4;0;4;
2017;1º;60250776;LUIZA ADMINISTRADORA DE CONSÓRCIOS LTDA;Descumprimento de prazo de resposta a demanda;1;1;0;2;
2017;1º;60250776;LUIZA ADMINISTRADORA DE CONSÓRCIOS LTDA;Insatisfação por parte do cliente com o atendimento prestado pela administradora de consórcio;0;0;1;1;
2017;1º;60250776;LUIZA ADMINISTRADORA DE CONSÓRCIOS LTDA;Prestação inadequada/insuficiente de informação;0;0;1;1;
2017;1º;04250224;MAGGI ADMINISTRADORA DE CONSÓRCIOS LTDA;Irregularidades relacionadas à liberação do crédito;0;1;0;1;
2017;1º;17249375;MAPFRE ADMINISTRADORA DE CONSÓRCIOS S.A.;Descumprimento de cláusulas referentes à devolução de valores;0;2;0;2;
2017;1º;17249375;MAPFRE ADMINISTRADORA DE CONSÓRCIOS S.A.;Descumprimento de prazo de resposta a demanda;1;0;0;1;
2017;1º;17249375;MAPFRE ADMINISTRADORA DE CONSÓRCIOS S.A.;Dificuldade na liberação ou substituição de bem;0;0;1;1;
2017;1º;17249375;MAPFRE ADMINISTRADORA DE CONSÓRCIOS S.A.;Insatisfação por parte do cliente com o atendimento prestado pela administradora de consórcio;0;0;1;1;
2017;1º;17249375;MAPFRE ADMINISTRADORA DE CONSÓRCIOS S.A.;Irregularidades relacionadas à liberação do crédito;0;1;0;1;
2017;1º;17249375;MAPFRE ADMINISTRADORA DE CONSÓRCIOS S.A.;Outras irregularidades;0;2;0;2;
2017;1º;17249375;MAPFRE ADMINISTRADORA DE CONSÓRCIOS S.A.;Prestação inadequada/insuficiente de informação;0;0;2;2;
2017;1º;17249375;MAPFRE ADMINISTRADORA DE CONSÓRCIOS S.A.;Publicidade enganosa;0;0;1;1;
2017;1º;45793395;MASSEY FERGUSON ADMINISTRADORA DE CONSÓRCIOS LTDA;Irregularidades relacionadas à liberação do crédito;0;1;0;1;
2017;1º;45793395;MASSEY FERGUSON ADMINISTRADORA DE CONSÓRCIOS LTDA;Irregularidades relacionadas às condições para contemplação por lance ou sorteio;0;1;0;1;
2017;1º;46349106;MERCABENCO MERCANTIL E ADMINISTRADORA DE BENS E CONSÓRCIOS LTDA.;Descumprimento de cláusulas referentes à devolução de valores;0;2;0;2;
2017;1º;46349106;MERCABENCO MERCANTIL E ADMINISTRADORA DE BENS E CONSÓRCIOS LTDA.;Descumprimento de obrigações previstas em contratos;0;2;0;2;
2017;1º;46349106;MERCABENCO MERCANTIL E ADMINISTRADORA DE BENS E CONSÓRCIOS LTDA.;Dificuldade na liberação ou substituição de bem;0;0;1;1;
2017;1º;46349106;MERCABENCO MERCANTIL E ADMINISTRADORA DE BENS E CONSÓRCIOS LTDA.;Insatisfação com a resposta fornecida pela administradora de consórcio relativa à demanda registrada contra ela;0;1;0;1;
2017;1º;46349106;MERCABENCO MERCANTIL E ADMINISTRADORA DE BENS E CONSÓRCIOS LTDA.;Prestação inadequada/insuficiente de informação;0;0;1;1;
2017;1º;71045363;MINASMÁQUINAS ADMINISTRADORA DE CONSÓRCIOS LTDA;Ausência de transparência nas relações contratuais;0;0;1;1;
2017;1º;71045363;MINASMÁQUINAS ADMINISTRADORA DE CONSÓRCIOS LTDA;Prestação inadequada/insuficiente de informação;0;0;1;1;
2017;1º;71045363;MINASMÁQUINAS ADMINISTRADORA DE CONSÓRCIOS LTDA;Recusa ou demora no fornecimento de documentos (exceto demonstrativos obrigatórios);0;0;1;1;
2017;1º;64479991;MINAUTO ADMINISTRADORA DE CONSÓRCIO LTDA.;Reclamações relacionadas a assuntos diversos;0;0;1;1;
2017;1º;05126027;MOTOASA ADMINISTRADORA DE CONSÓRCIOS LTDA.;Descumprimento de obrigações previstas em contratos;1;0;0;1;
2017;1º;05126027;MOTOASA ADMINISTRADORA DE CONSÓRCIOS LTDA.;Prestação inadequada/insuficiente de informação;0;0;2;2;
2017;1º;05126027;MOTOASA ADMINISTRADORA DE CONSÓRCIOS LTDA.;Reclamações relacionadas a assuntos diversos;0;0;1;1;
2017;1º;04124922;MULTIMARCAS ADMINISTRADORA DE CONSORCIOS LTDA.;Ausência de transparência nas relações contratuais;0;0;2;2;
2017;1º;04124922;MULTIMARCAS ADMINISTRADORA DE CONSORCIOS LTDA.;Descumprimento de cláusulas referentes à devolução de valores;0;4;0;4;
2017;1º;04124922;MULTIMARCAS ADMINISTRADORA DE CONSORCIOS LTDA.;Descumprimento de obrigações previstas em contratos;0;1;0;1;
2017;1º;04124922;MULTIMARCAS ADMINISTRADORA DE CONSORCIOS LTDA.;Descumprimento de prazo de resposta a demanda;1;1;0;2;
2017;1º;04124922;MULTIMARCAS ADMINISTRADORA DE CONSORCIOS LTDA.;Insatisfação com a resposta fornecida pela administradora de consórcio relativa à demanda registrada contra ela;0;1;0;1;
2017;1º;04124922;MULTIMARCAS ADMINISTRADORA DE CONSORCIOS LTDA.;Outras irregularidades;1;12;0;13;
2017;1º;04124922;MULTIMARCAS ADMINISTRADORA DE CONSORCIOS LTDA.;Prestação inadequada/insuficiente de informação;0;0;11;11;
2017;1º;04124922;MULTIMARCAS ADMINISTRADORA DE CONSORCIOS LTDA.;Publicidade enganosa;0;0;6;6;
2017;1º;04124922;MULTIMARCAS ADMINISTRADORA DE CONSORCIOS LTDA.;Reclamações relacionadas a assuntos diversos;0;0;1;1;
2017;1º;04124922;MULTIMARCAS ADMINISTRADORA DE CONSORCIOS LTDA.;Recusa ou demora no fornecimento de documentos (exceto demonstrativos obrigatórios);0;0;4;4;
2017;1º;05652765;NANUQUE ADMINISTRADORA DE CONSÓRCIOS LTDA.;Prestação inadequada/insuficiente de informação;0;0;2;2;
2017;1º;05652765;NANUQUE ADMINISTRADORA DE CONSÓRCIOS LTDA.;Recusa ou demora no fornecimento de documentos (exceto demonstrativos obrigatórios);0;0;1;1;
2017;1º;05395814;NOVOTEMPO ADMINISTRADORA DE CONSORCIOS LTDA.;Descumprimento de prazo de resposta a demanda;0;1;0;1;
2017;1º;50533876;PANAMERICANO ADMINISTRADORA DE CONSÓRCIO LTDA;Ausência de transparência nas relações contratuais;0;0;5;5;
2017;1º;50533876;PANAMERICANO ADMINISTRADORA DE CONSÓRCIO LTDA;Descumprimento de cláusulas referentes à devolução de valores;0;8;0;8;
2017;1º;50533876;PANAMERICANO ADMINISTRADORA DE CONSÓRCIO LTDA;Descumprimento de prazo de resposta a demanda;0;1;0;1;
2017;1º;50533876;PANAMERICANO ADMINISTRADORA DE CONSÓRCIO LTDA;Dificuldade na liberação ou substituição de bem;0;0;2;2;
2017;1º;50533876;PANAMERICANO ADMINISTRADORA DE CONSÓRCIO LTDA;Insatisfação com a resposta fornecida pela administradora de consórcio relativa à demanda registrada contra ela;1;0;0;1;
2017;1º;50533876;PANAMERICANO ADMINISTRADORA DE CONSÓRCIO LTDA;Insatisfação por parte do cliente com o atendimento prestado pela administradora de consórcio;0;0;12;12;
2017;1º;50533876;PANAMERICANO ADMINISTRADORA DE CONSÓRCIO LTDA;Irregularidades relacionadas à liberação do crédito;0;8;0;8;
2017;1º;50533876;PANAMERICANO ADMINISTRADORA DE CONSÓRCIO LTDA;Irregularidades relacionadas às condições para contemplação por lance ou sorteio;0;1;0;1;
2017;1º;50533876;PANAMERICANO ADMINISTRADORA DE CONSÓRCIO LTDA;Reclamações relacionadas a assuntos diversos;0;0;3;3;
2017;1º;50533876;PANAMERICANO ADMINISTRADORA DE CONSÓRCIO LTDA;Recusa ou demora no fornecimento de documentos (exceto demonstrativos obrigatórios);0;0;1;1;
2017;1º;16551061;PONTA ADMINISTRADORA DE CONSORCIOS LTDA;Ausência de transparência nas relações contratuais;0;0;4;4;
2017;1º;16551061;PONTA ADMINISTRADORA DE CONSORCIOS LTDA;Descumprimento de cláusulas referentes à devolução de valores;0;1;0;1;
2017;1º;16551061;PONTA ADMINISTRADORA DE CONSORCIOS LTDA;Dificuldade na liberação ou substituição de bem;0;0;1;1;
2017;1º;16551061;PONTA ADMINISTRADORA DE CONSORCIOS LTDA;Insatisfação com a resposta fornecida pela administradora de consórcio relativa à demanda registrada contra ela;2;0;0;2;
2017;1º;16551061;PONTA ADMINISTRADORA DE CONSORCIOS LTDA;Insatisfação por parte do cliente com o atendimento prestado pela administradora de consórcio;0;0;2;2;
2017;1º;16551061;PONTA ADMINISTRADORA DE CONSORCIOS LTDA;Irregularidades relacionadas à liberação do crédito;0;4;0;4;
2017;1º;16551061;PONTA ADMINISTRADORA DE CONSORCIOS LTDA;Irregularidades relacionadas às condições para contemplação por lance ou sorteio;0;2;0;2;
2017;1º;48041735;PORTO SEGURO ADMINISTRADORA DE CONSÓRCIOS LTDA;Ausência de transparência nas relações contratuais;0;0;7;7;
2017;1º;48041735;PORTO SEGURO ADMINISTRADORA DE CONSÓRCIOS LTDA;Descumprimento de cláusulas referentes à devolução de valores;0;5;0;5;
2017;1º;48041735;PORTO SEGURO ADMINISTRADORA DE CONSÓRCIOS LTDA;Descumprimento de obrigações previstas em contratos;0;1;0;1;
2017;1º;48041735;PORTO SEGURO ADMINISTRADORA DE CONSÓRCIOS LTDA;Insatisfação com a resposta fornecida pela administradora de consórcio relativa à demanda registrada contra ela;0;3;0;3;
2017;1º;48041735;PORTO SEGURO ADMINISTRADORA DE CONSÓRCIOS LTDA;Insatisfação por parte do cliente com o atendimento prestado pela administradora de consórcio;0;0;9;9;
2017;1º;48041735;PORTO SEGURO ADMINISTRADORA DE CONSÓRCIOS LTDA;Irregularidades relacionadas à liberação do crédito;0;9;0;9;
2017;1º;48041735;PORTO SEGURO ADMINISTRADORA DE CONSÓRCIOS LTDA;Irregularidades relacionadas às condições para contemplação por lance ou sorteio;0;2;0;2;
2017;1º;48041735;PORTO SEGURO ADMINISTRADORA DE CONSÓRCIOS LTDA;Prestação inadequada/insuficiente de informação;0;0;4;4;
2017;1º;48041735;PORTO SEGURO ADMINISTRADORA DE CONSÓRCIOS LTDA;Publicidade enganosa;0;0;2;2;
2017;1º;48041735;PORTO SEGURO ADMINISTRADORA DE CONSÓRCIOS LTDA;Reclamações relacionadas a assuntos diversos;0;0;7;7;
2017;1º;48041735;PORTO SEGURO ADMINISTRADORA DE CONSÓRCIOS LTDA;Recusa ou demora no fornecimento de documentos (exceto demonstrativos obrigatórios);0;0;1;1;
2017;1º;87433413;PORTOBENS ADMINISTRADORA DE CONSORCIOS LTDA;Ausência de transparência nas relações contratuais;0;0;1;1;
2017;1º;87433413;PORTOBENS ADMINISTRADORA DE CONSORCIOS LTDA;Irregularidades relacionadas à liberação do crédito;0;1;0;1;
2017;1º;51597300;PRIMO ROSSI ADMINISTRADORA DE CONSÓRCIO LTDA.;Descumprimento de cláusulas referentes à devolução de valores;0;9;0;9;
2017;1º;51597300;PRIMO ROSSI ADMINISTRADORA DE CONSÓRCIO LTDA.;Descumprimento de obrigações previstas em contratos;1;0;0;1;
2017;1º;51597300;PRIMO ROSSI ADMINISTRADORA DE CONSÓRCIO LTDA.;Prestação inadequada/insuficiente de informação;0;0;1;1;
2017;1º;51597300;PRIMO ROSSI ADMINISTRADORA DE CONSÓRCIO LTDA.;Recusa ou demora no fornecimento de documentos (exceto demonstrativos obrigatórios);0;0;2;2;
2017;1º;91108027;RANDON ADMINISTRADORA DE CONSÓRCIOS LTDA.;Descumprimento de cláusulas referentes à devolução de valores;0;3;0;3;
2017;1º;91108027;RANDON ADMINISTRADORA DE CONSÓRCIOS LTDA.;Descumprimento de obrigações previstas em contratos;0;3;0;3;
2017;1º;91108027;RANDON ADMINISTRADORA DE CONSÓRCIOS LTDA.;Dificuldade na liberação ou substituição de bem;0;0;1;1;
2017;1º;91108027;RANDON ADMINISTRADORA DE CONSÓRCIOS LTDA.;Insatisfação por parte do cliente com o atendimento prestado pela administradora de consórcio;0;0;3;3;
2017;1º;91108027;RANDON ADMINISTRADORA DE CONSÓRCIOS LTDA.;Irregularidades relacionadas à liberação do crédito;0;3;0;3;
2017;1º;91108027;RANDON ADMINISTRADORA DE CONSÓRCIOS LTDA.;Prestação inadequada/insuficiente de informação;0;0;1;1;
2017;1º;91108027;RANDON ADMINISTRADORA DE CONSÓRCIOS LTDA.;Reclamações relacionadas a assuntos diversos;0;0;2;2;
2017;1º;66228966;REALIZA ADMINISTRADORA DE CONSÓRCIOS LTDA.;Ausência de transparência nas relações contratuais;0;0;1;1;
2017;1º;66228966;REALIZA ADMINISTRADORA DE CONSÓRCIOS LTDA.;Descumprimento de cláusulas referentes à devolução de valores;0;10;0;10;
2017;1º;66228966;REALIZA ADMINISTRADORA DE CONSÓRCIOS LTDA.;Descumprimento de obrigações previstas em contratos;1;3;0;4;
2017;1º;66228966;REALIZA ADMINISTRADORA DE CONSÓRCIOS LTDA.;Insatisfação com a resposta fornecida pela administradora de consórcio relativa à demanda registrada contra ela;0;9;0;9;
2017;1º;66228966;REALIZA ADMINISTRADORA DE CONSÓRCIOS LTDA.;Insatisfação por parte do cliente com o atendimento prestado pela administradora de consórcio;0;0;3;3;
2017;1º;66228966;REALIZA ADMINISTRADORA DE CONSÓRCIOS LTDA.;Irregularidades relacionadas à liberação do crédito;0;2;0;2;
2017;1º;66228966;REALIZA ADMINISTRADORA DE CONSÓRCIOS LTDA.;Irregularidades relacionadas às condições para contemplação por lance ou sorteio;0;3;0;3;
2017;1º;66228966;REALIZA ADMINISTRADORA DE CONSÓRCIOS LTDA.;Outras irregularidades;1;17;0;18;
2017;1º;66228966;REALIZA ADMINISTRADORA DE CONSÓRCIOS LTDA.;Outras irregularidades relacionadas à Ouvidoria;0;1;0;1;
2017;1º;66228966;REALIZA ADMINISTRADORA DE CONSÓRCIOS LTDA.;Prestação inadequada/insuficiente de informação;0;0;9;9;
2017;1º;66228966;REALIZA ADMINISTRADORA DE CONSÓRCIOS LTDA.;Publicidade enganosa;0;0;10;10;
2017;1º;66228966;REALIZA ADMINISTRADORA DE CONSÓRCIOS LTDA.;Reclamações relacionadas a assuntos diversos;0;0;12;12;
2017;1º;66228966;REALIZA ADMINISTRADORA DE CONSÓRCIOS LTDA.;Recusa ou demora no fornecimento de documentos (exceto demonstrativos obrigatórios);0;0;1;1;
2017;1º;23767155;RECON ADMINISTRADORA DE CONSORCIOS LTDA;Descumprimento de cláusulas referentes à devolução de valores;0;3;0;3;
2017;1º;23767155;RECON ADMINISTRADORA DE CONSORCIOS LTDA;Outras irregularidades;0;1;0;1;
2017;1º;23767155;RECON ADMINISTRADORA DE CONSORCIOS LTDA;Outras irregularidades relacionadas à Ouvidoria;0;1;0;1;
2017;1º;23767155;RECON ADMINISTRADORA DE CONSORCIOS LTDA;Publicidade enganosa;0;0;1;1;
2017;1º;23767155;RECON ADMINISTRADORA DE CONSORCIOS LTDA;Recusa ou demora no fornecimento de documentos (exceto demonstrativos obrigatórios);0;0;1;1;
2017;1º;92002609;REDE OESTE ADMINISTRADORA DE CONSORCIOS LTDA.;Descumprimento de obrigações previstas em contratos;0;1;0;1;
2017;1º;62354055;REMAZA ADMINISTRADORA DE CONSÓRCIO LTDA.;Descumprimento de cláusulas referentes à devolução de valores;0;14;0;14;
2017;1º;62354055;REMAZA ADMINISTRADORA DE CONSÓRCIO LTDA.;Descumprimento de prazo de resposta a demanda;0;1;0;1;
2017;1º;62354055;REMAZA ADMINISTRADORA DE CONSÓRCIO LTDA.;Insatisfação com a resposta fornecida pela administradora de consórcio relativa à demanda registrada contra ela;1;4;0;5;
2017;1º;62354055;REMAZA ADMINISTRADORA DE CONSÓRCIO LTDA.;Insatisfação por parte do cliente com o atendimento prestado pela administradora de consórcio;0;0;1;1;
2017;1º;62354055;REMAZA ADMINISTRADORA DE CONSÓRCIO LTDA.;Irregularidades relacionadas à liberação do crédito;0;3;0;3;
2017;1º;62354055;REMAZA ADMINISTRADORA DE CONSÓRCIO LTDA.;Irregularidades relacionadas às condições para contemplação por lance ou sorteio;0;1;0;1;
2017;1º;62354055;REMAZA ADMINISTRADORA DE CONSÓRCIO LTDA.;Prestação inadequada/insuficiente de informação;0;0;14;14;
2017;1º;62354055;REMAZA ADMINISTRADORA DE CONSÓRCIO LTDA.;Publicidade enganosa;0;0;11;11;
2017;1º;62354055;REMAZA ADMINISTRADORA DE CONSÓRCIO LTDA.;Reclamações relacionadas a assuntos diversos;0;0;1;1;
2017;1º;80402746;RIVEL ADMINISTRADORA DE CONSÓRCIOS LTDA.;Ausência de transparência nas relações contratuais;0;0;1;1;
2017;1º;80402746;RIVEL ADMINISTRADORA DE CONSÓRCIOS LTDA.;Descumprimento de cláusulas referentes à devolução de valores;0;1;0;1;
2017;1º;51855716;RODOBENS ADMINISTRADORA DE CONSÓRCIOS LTDA.;Ausência de transparência nas relações contratuais;0;0;7;7;
2017;1º;51855716;RODOBENS ADMINISTRADORA DE CONSÓRCIOS LTDA.;Descumprimento de cláusulas referentes à devolução de valores;0;13;0;13;
2017;1º;51855716;RODOBENS ADMINISTRADORA DE CONSÓRCIOS LTDA.;Descumprimento de obrigações previstas em contratos;0;2;0;2;
2017;1º;51855716;RODOBENS ADMINISTRADORA DE CONSÓRCIOS LTDA.;Descumprimento de prazo de resposta a demanda;0;1;0;1;
2017;1º;51855716;RODOBENS ADMINISTRADORA DE CONSÓRCIOS LTDA.;Dificuldade na liberação ou substituição de bem;0;0;4;4;
2017;1º;51855716;RODOBENS ADMINISTRADORA DE CONSÓRCIOS LTDA.;Insatisfação com a resposta fornecida pela administradora de consórcio relativa à demanda registrada contra ela;1;3;0;4;
2017;1º;51855716;RODOBENS ADMINISTRADORA DE CONSÓRCIOS LTDA.;Insatisfação por parte do cliente com o atendimento prestado pela administradora de consórcio;0;0;7;7;
2017;1º;51855716;RODOBENS ADMINISTRADORA DE CONSÓRCIOS LTDA.;Irregularidades relacionadas à liberação do crédito;0;3;0;3;
2017;1º;51855716;RODOBENS ADMINISTRADORA DE CONSÓRCIOS LTDA.;Irregularidades relacionadas às condições para contemplação por lance ou sorteio;0;4;0;4;
2017;1º;51855716;RODOBENS ADMINISTRADORA DE CONSÓRCIOS LTDA.;Não fornecimento, remessa ou divulgação de documentos obrigatórios;0;1;0;1;
2017;1º;51855716;RODOBENS ADMINISTRADORA DE CONSÓRCIOS LTDA.;Outras irregularidades relacionadas à Ouvidoria;0;1;0;1;
2017;1º;51855716;RODOBENS ADMINISTRADORA DE CONSÓRCIOS LTDA.;Prestação inadequada/insuficiente de informação;0;0;6;6;
2017;1º;51855716;RODOBENS ADMINISTRADORA DE CONSÓRCIOS LTDA.;Publicidade enganosa;0;0;5;5;
2017;1º;51855716;RODOBENS ADMINISTRADORA DE CONSÓRCIOS LTDA.;Reclamações relacionadas a assuntos diversos;0;0;7;7;
2017;1º;51855716;RODOBENS ADMINISTRADORA DE CONSÓRCIOS LTDA.;Recusa ou demora no fornecimento de documentos (exceto demonstrativos obrigatórios);0;0;2;2;
2017;1º;80674393;SANTA FÉ ADMINISTRADORA DE CONSÓRCIOS LTDA.;Descumprimento de cláusulas referentes à devolução de valores;0;1;0;1;
2017;1º;80674393;SANTA FÉ ADMINISTRADORA DE CONSÓRCIOS LTDA.;Outras irregularidades;0;1;0;1;
2017;1º;55942312;SANTANDER BRASIL ADMINISTRADORA DE CONSÓRCIO LTDA.;Ausência de informações/cláusulas obrigatórias em contrato;1;0;0;1;
2017;1º;55942312;SANTANDER BRASIL ADMINISTRADORA DE CONSÓRCIO LTDA.;Ausência de transparência nas relações contratuais;0;0;6;6;
2017;1º;55942312;SANTANDER BRASIL ADMINISTRADORA DE CONSÓRCIO LTDA.;Cobrança irregular de tarifa pela emissão de boletos, carnês e assemelhados;0;1;0;1;
2017;1º;55942312;SANTANDER BRASIL ADMINISTRADORA DE CONSÓRCIO LTDA.;Descumprimento de cláusulas referentes à devolução de valores;0;6;0;6;
2017;1º;55942312;SANTANDER BRASIL ADMINISTRADORA DE CONSÓRCIO LTDA.;Descumprimento de obrigações previstas em contratos;0;2;0;2;
2017;1º;55942312;SANTANDER BRASIL ADMINISTRADORA DE CONSÓRCIO LTDA.;Descumprimento de prazo de resposta a demanda;0;1;0;1;
2017;1º;55942312;SANTANDER BRASIL ADMINISTRADORA DE CONSÓRCIO LTDA.;Insatisfação com a resposta fornecida pela administradora de consórcio relativa à demanda registrada contra ela;0;1;0;1;
2017;1º;55942312;SANTANDER BRASIL ADMINISTRADORA DE CONSÓRCIO LTDA.;Insatisfação por parte do cliente com o atendimento prestado pela administradora de consórcio;0;0;7;7;
2017;1º;55942312;SANTANDER BRASIL ADMINISTRADORA DE CONSÓRCIO LTDA.;Irregularidades relacionadas à liberação do crédito;1;9;0;10;
2017;1º;55942312;SANTANDER BRASIL ADMINISTRADORA DE CONSÓRCIO LTDA.;Irregularidades relacionadas às condições para contemplação por lance ou sorteio;0;4;0;4;
2017;1º;55942312;SANTANDER BRASIL ADMINISTRADORA DE CONSÓRCIO LTDA.;Outras irregularidades;0;1;0;1;
2017;1º;55942312;SANTANDER BRASIL ADMINISTRADORA DE CONSÓRCIO LTDA.;Prestação inadequada/insuficiente de informação;0;0;4;4;
2017;1º;55942312;SANTANDER BRASIL ADMINISTRADORA DE CONSÓRCIO LTDA.;Recusa ou demora no fornecimento de documentos (exceto demonstrativos obrigatórios);0;0;2;2;
2017;1º;96479258;SCANIA ADMINISTRADORA DE CONSÓRCIOS LTDA.;Descumprimento de cláusulas referentes à devolução de valores;0;1;0;1;
2017;1º;96479258;SCANIA ADMINISTRADORA DE CONSÓRCIOS LTDA.;Irregularidades relacionadas à liberação do crédito;0;1;0;1;
2017;1º;76515071;SERVOPA ADMINISTRADORA DE CONSORCIOS LTDA;Ausência de transparência nas relações contratuais;0;0;1;1;
2017;1º;76515071;SERVOPA ADMINISTRADORA DE CONSORCIOS LTDA;Descumprimento de cláusulas referentes à devolução de valores;0;2;0;2;
2017;1º;76515071;SERVOPA ADMINISTRADORA DE CONSORCIOS LTDA;Outras irregularidades;0;1;0;1;
2017;1º;76515071;SERVOPA ADMINISTRADORA DE CONSORCIOS LTDA;Prestação inadequada/insuficiente de informação;0;0;5;5;
2017;1º;50543883;SIMÃO ADMINISTRADORA DE CONSÓRCIOS LTDA;Descumprimento de cláusulas referentes à devolução de valores;0;1;0;1;
2017;1º;87852273;SINOSSERRA ADMINISTRADORA DE CONSÓRCIOS S/A.;Descumprimento de obrigações previstas em contratos;0;1;0;1;
2017;1º;87852273;SINOSSERRA ADMINISTRADORA DE CONSÓRCIOS S/A.;Publicidade enganosa;0;0;1;1;
2017;1º;54708839;SPERTA ADMINISTRADORA DE CONSORCIO NACIONAL LTDA;Ausência de transparência nas relações contratuais;0;0;1;1;
2017;1º;54708839;SPERTA ADMINISTRADORA DE CONSORCIO NACIONAL LTDA;Descumprimento de obrigações previstas em contratos;1;0;0;1;
2017;1º;57723801;SUZUKI MOTOS ADMINISTRADORA DE CONSÓRCIO LTDA.;Ausência de transparência nas relações contratuais;0;0;1;1;
2017;1º;57723801;SUZUKI MOTOS ADMINISTRADORA DE CONSÓRCIO LTDA.;Descumprimento de cláusulas referentes à devolução de valores;0;1;0;1;
2017;1º;57723801;SUZUKI MOTOS ADMINISTRADORA DE CONSÓRCIO LTDA.;Insatisfação com a resposta fornecida pela administradora de consórcio relativa à demanda registrada contra ela;0;1;0;1;
2017;1º;57723801;SUZUKI MOTOS ADMINISTRADORA DE CONSÓRCIO LTDA.;Insatisfação por parte do cliente com o atendimento prestado pela administradora de consórcio;0;0;4;4;
2017;1º;57723801;SUZUKI MOTOS ADMINISTRADORA DE CONSÓRCIO LTDA.;Recusa ou demora no fornecimento de documentos (exceto demonstrativos obrigatórios);0;0;1;1;
2017;1º;53211488;TARRAF ADMINISTRADORA DE CONSÓRCIOS LTDA.;Prestação inadequada/insuficiente de informação;0;0;1;1;
2017;1º;59956185;TRADIÇÃO ADMINISTRADORA DE CONSÓRCIO LTDA.;Descumprimento de cláusulas referentes à devolução de valores;0;1;0;1;
2017;1º;59956185;TRADIÇÃO ADMINISTRADORA DE CONSÓRCIO LTDA.;Descumprimento de obrigações previstas em contratos;0;1;0;1;
2017;1º;59956185;TRADIÇÃO ADMINISTRADORA DE CONSÓRCIO LTDA.;Descumprimento de prazo de resposta a demanda;0;1;0;1;
2017;1º;59956185;TRADIÇÃO ADMINISTRADORA DE CONSÓRCIO LTDA.;Prestação inadequada/insuficiente de informação;0;0;3;3;
2017;1º;59956185;TRADIÇÃO ADMINISTRADORA DE CONSÓRCIO LTDA.;Publicidade enganosa;0;0;1;1;
2017;1º;83553883;UNIÃO CATARINENSE ADMINISTRADORA DE CONSORCIOS LTDA;Irregularidades relacionadas às condições para contemplação por lance ou sorteio;0;1;0;1;
2017;1º;83553883;UNIÃO CATARINENSE ADMINISTRADORA DE CONSORCIOS LTDA;Prestação inadequada/insuficiente de informação;0;0;1;1;
2017;1º;60732997;UNIFISA ADMINISTRADORA NACIONAL DE CONSORCIOS LTDA;Ausência de transparência nas relações contratuais;0;0;1;1;
2017;1º;60732997;UNIFISA ADMINISTRADORA NACIONAL DE CONSORCIOS LTDA;Descumprimento de cláusulas referentes à devolução de valores;0;1;0;1;
2017;1º;60732997;UNIFISA ADMINISTRADORA NACIONAL DE CONSORCIOS LTDA;Descumprimento de obrigações previstas em contratos;0;1;0;1;
2017;1º;60732997;UNIFISA ADMINISTRADORA NACIONAL DE CONSORCIOS LTDA;Insatisfação por parte do cliente com o atendimento prestado pela administradora de consórcio;0;0;1;1;
2017;1º;60732997;UNIFISA ADMINISTRADORA NACIONAL DE CONSORCIOS LTDA;Prestação inadequada/insuficiente de informação;0;0;2;2;
2017;1º;60732997;UNIFISA ADMINISTRADORA NACIONAL DE CONSORCIOS LTDA;Publicidade enganosa;0;0;3;3;
2017;1º;81269516;UNILANCE ADMINISTRADORA DE CONSÓRCIOS LTDA.;Ausência de transparência nas relações contratuais;0;0;2;2;
2017;1º;81269516;UNILANCE ADMINISTRADORA DE CONSÓRCIOS LTDA.;Descumprimento de cláusulas referentes à devolução de valores;0;7;0;7;
2017;1º;81269516;UNILANCE ADMINISTRADORA DE CONSÓRCIOS LTDA.;Descumprimento de obrigações previstas em contratos;0;1;0;1;
2017;1º;81269516;UNILANCE ADMINISTRADORA DE CONSÓRCIOS LTDA.;Descumprimento de prazo de resposta a demanda;0;2;0;2;
2017;1º;81269516;UNILANCE ADMINISTRADORA DE CONSÓRCIOS LTDA.;Insatisfação com a resposta fornecida pela administradora de consórcio relativa à demanda registrada contra ela;0;5;0;5;
2017;1º;81269516;UNILANCE ADMINISTRADORA DE CONSÓRCIOS LTDA.;Insatisfação por parte do cliente com o atendimento prestado pela administradora de consórcio;0;0;1;1;
2017;1º;81269516;UNILANCE ADMINISTRADORA DE CONSÓRCIOS LTDA.;Irregularidades relacionadas à liberação do crédito;0;2;0;2;
2017;1º;81269516;UNILANCE ADMINISTRADORA DE CONSÓRCIOS LTDA.;Irregularidades relacionadas às condições para contemplação por lance ou sorteio;0;2;0;2;
2017;1º;81269516;UNILANCE ADMINISTRADORA DE CONSÓRCIOS LTDA.;Não disponibilização de acesso telefônico gratuito à Ouvidoria;1;0;0;1;
2017;1º;81269516;UNILANCE ADMINISTRADORA DE CONSÓRCIOS LTDA.;Outras irregularidades;0;9;0;9;
2017;1º;81269516;UNILANCE ADMINISTRADORA DE CONSÓRCIOS LTDA.;Prestação inadequada/insuficiente de informação;0;0;5;5;
2017;1º;81269516;UNILANCE ADMINISTRADORA DE CONSÓRCIOS LTDA.;Publicidade enganosa;0;0;2;2;
2017;1º;81269516;UNILANCE ADMINISTRADORA DE CONSÓRCIOS LTDA.;Reclamações relacionadas a assuntos diversos;0;0;1;1;
2017;1º;56360266;VALTRA ADMINISTRADORA DE CONSÓRCIOS LTDA;Descumprimento de prazo de resposta a demanda;0;1;0;1;
2017;1º;56360266;VALTRA ADMINISTRADORA DE CONSÓRCIOS LTDA;Prestação inadequada/insuficiente de informação;0;0;2;2;
2017;1º;45594223;VEMAR ADMINISTRADORA DE CONSÓRCIO LTDA.;Descumprimento de prazo de resposta a demanda;0;1;0;1;
2017;1º;45594223;VEMAR ADMINISTRADORA DE CONSÓRCIO LTDA.;Irregularidades relacionadas à liberação do crédito;0;1;0;1;
2017;1º;74118381;VOLVO ADMINISTRADORA DE CONSÓRCIO LTDA.;Ausência de transparência nas relações contratuais;0;0;2;2;
2017;1º;74118381;VOLVO ADMINISTRADORA DE CONSÓRCIO LTDA.;Irregularidades relacionadas às condições para contemplação por lance ou sorteio;0;1;0;1;
2017;1º;47458153;YAMAHA ADMINISTRADORA DE CONSÓRCIO LTDA.;Ausência de transparência nas relações contratuais;0;0;1;1;
2017;1º;47458153;YAMAHA ADMINISTRADORA DE CONSÓRCIO LTDA.;Descumprimento de cláusulas referentes à devolução de valores;0;4;0;4;
2017;1º;47458153;YAMAHA ADMINISTRADORA DE CONSÓRCIO LTDA.;Descumprimento de obrigações previstas em contratos;0;3;0;3;
2017;1º;47458153;YAMAHA ADMINISTRADORA DE CONSÓRCIO LTDA.;Dificuldade na liberação ou substituição de bem;0;0;2;2;
2017;1º;47458153;YAMAHA ADMINISTRADORA DE CONSÓRCIO LTDA.;Irregularidades relacionadas à liberação do crédito;0;7;0;7;
2017;1º;47458153;YAMAHA ADMINISTRADORA DE CONSÓRCIO LTDA.;Prestação inadequada/insuficiente de informação;0;0;2;2;
2017;1º;47458153;YAMAHA ADMINISTRADORA DE CONSÓRCIO LTDA.;Publicidade enganosa;0;0;1;1;
2017;1º;47458153;YAMAHA ADMINISTRADORA DE CONSÓRCIO LTDA.;Reclamações relacionadas a assuntos diversos;0;0;1;1;
2017;1º;23367634;ZEMA ADMINISTRADORA DE CONSÓRCIO LTDA;Ausência de transparência nas relações contratuais;0;0;1;1;
2017;1º;23367634;ZEMA ADMINISTRADORA DE CONSÓRCIO LTDA;Descumprimento de cláusulas referentes à devolução de valores;0;3;0;3;
2017;1º;23367634;ZEMA ADMINISTRADORA DE CONSÓRCIO LTDA;Descumprimento de prazo de resposta a demanda;2;0;0;2;
2017;1º;23367634;ZEMA ADMINISTRADORA DE CONSÓRCIO LTDA;Insatisfação com a resposta fornecida pela administradora de consórcio relativa à demanda registrada contra ela;1;0;0;1;
2017;1º;23367634;ZEMA ADMINISTRADORA DE CONSÓRCIO LTDA;Irregularidades relacionadas à liberação do crédito;0;1;0;1;
2017;1º;23367634;ZEMA ADMINISTRADORA DE CONSÓRCIO LTDA;Outras irregularidades;0;9;0;9;
2017;1º;23367634;ZEMA ADMINISTRADORA DE CONSÓRCIO LTDA;Prestação inadequada/insuficiente de informação;0;0;7;7;
2017;1º;23367634;ZEMA ADMINISTRADORA DE CONSÓRCIO LTDA;Recusa ou demora no fornecimento de documentos (exceto demonstrativos obrigatórios);0;0;6;6;
