Ano;Semestre;CNPJ AC;Administradora de consórcio;Irregularidade;Quantidade de reclamações reguladas procedentes;Quantidade de reclamações reguladas - outras;Quantidade de reclamações não reguladas;Quantidade total de reclamações;
2017;2º;91984633;ACERTE ADMINISTRADORA DE CONSÓRCIOS LTDA.;Cobrança irregular de tarifa pela emissão de boletos, carnês e assemelhados;0;1;0;1;
2017;2º;91984633;ACERTE ADMINISTRADORA DE CONSÓRCIOS LTDA.;Descumprimento de cláusulas referentes à devolução de valores;0;1;0;1;
2017;2º;91984633;ACERTE ADMINISTRADORA DE CONSÓRCIOS LTDA.;Descumprimento de obrigações previstas em contratos;0;2;0;2;
2017;2º;91984633;ACERTE ADMINISTRADORA DE CONSÓRCIOS LTDA.;Descumprimento de prazo de resposta a demanda;0;1;0;1;
2017;2º;91984633;ACERTE ADMINISTRADORA DE CONSÓRCIOS LTDA.;Insatisfação com a resposta fornecida pela administradora de consórcio relativa à demanda registrada contra ela;0;4;0;4;
2017;2º;91984633;ACERTE ADMINISTRADORA DE CONSÓRCIOS LTDA.;Outras irregularidades;0;24;0;24;
2017;2º;91984633;ACERTE ADMINISTRADORA DE CONSÓRCIOS LTDA.;Reclamações relacionadas a assuntos diversos;0;0;1;1;
2017;2º;91984633;ACERTE ADMINISTRADORA DE CONSÓRCIOS LTDA.;Recusa ou demora no fornecimento de documentos (exceto demonstrativos obrigatórios);0;0;2;2;
2017;2º;84911098;ADEMILAR ADMINISTRADORA DE CONSORCIOS S.A.;Descumprimento de obrigações previstas em contratos;0;1;0;1;
2017;2º;84911098;ADEMILAR ADMINISTRADORA DE CONSORCIOS S.A.;Prestação inadequada/insuficiente de informação;0;0;1;1;
2017;2º;06044551;ADMINISTRADORA DE CONSORCIO NACIONAL GAZIN LTDA;Ausência de transparência nas relações contratuais;0;0;1;1;
2017;2º;06044551;ADMINISTRADORA DE CONSORCIO NACIONAL GAZIN LTDA;Insatisfação por parte do cliente com o atendimento prestado pela administradora de consórcio;0;0;1;1;
2017;2º;06044551;ADMINISTRADORA DE CONSORCIO NACIONAL GAZIN LTDA;Irregularidades relacionadas às condições para contemplação por lance ou sorteio;0;1;0;1;
2017;2º;06044551;ADMINISTRADORA DE CONSORCIO NACIONAL GAZIN LTDA;Publicidade enganosa;0;0;1;1;
2017;2º;45441789;ADMINISTRADORA DE CONSORCIO NACIONAL HONDA LTDA;Ausência de transparência nas relações contratuais;0;0;8;8;
2017;2º;45441789;ADMINISTRADORA DE CONSORCIO NACIONAL HONDA LTDA;Descumprimento de cláusulas referentes à devolução de valores;1;26;0;27;
2017;2º;45441789;ADMINISTRADORA DE CONSORCIO NACIONAL HONDA LTDA;Descumprimento de obrigações previstas em contratos;2;8;0;10;
2017;2º;45441789;ADMINISTRADORA DE CONSORCIO NACIONAL HONDA LTDA;Descumprimento de prazo de resposta a demanda;2;1;0;3;
2017;2º;45441789;ADMINISTRADORA DE CONSORCIO NACIONAL HONDA LTDA;Descumprimento de prazo para apresentação de resposta conclusiva pela Ouvidoria;0;2;0;2;
2017;2º;45441789;ADMINISTRADORA DE CONSORCIO NACIONAL HONDA LTDA;Dificuldade na liberação ou substituição de bem;0;0;4;4;
2017;2º;45441789;ADMINISTRADORA DE CONSORCIO NACIONAL HONDA LTDA;Insatisfação com a resposta fornecida pela administradora de consórcio relativa à demanda registrada contra ela;1;3;0;4;
2017;2º;45441789;ADMINISTRADORA DE CONSORCIO NACIONAL HONDA LTDA;Insatisfação por parte do cliente com o atendimento prestado pela administradora de consórcio;0;0;6;6;
2017;2º;45441789;ADMINISTRADORA DE CONSORCIO NACIONAL HONDA LTDA;Irregularidades relacionadas à liberação do crédito;3;37;0;40;
2017;2º;45441789;ADMINISTRADORA DE CONSORCIO NACIONAL HONDA LTDA;Irregularidades relacionadas às condições para contemplação por lance ou sorteio;1;6;0;7;
2017;2º;45441789;ADMINISTRADORA DE CONSORCIO NACIONAL HONDA LTDA;Outras irregularidades;1;0;0;1;
2017;2º;45441789;ADMINISTRADORA DE CONSORCIO NACIONAL HONDA LTDA;Prestação inadequada/insuficiente de informação;0;0;6;6;
2017;2º;45441789;ADMINISTRADORA DE CONSORCIO NACIONAL HONDA LTDA;Publicidade enganosa;0;0;1;1;
2017;2º;45441789;ADMINISTRADORA DE CONSORCIO NACIONAL HONDA LTDA;Reclamações relacionadas a assuntos diversos;0;0;19;19;
2017;2º;45441789;ADMINISTRADORA DE CONSORCIO NACIONAL HONDA LTDA;Recusa ou demora no fornecimento de documentos (exceto demonstrativos obrigatórios);0;0;18;18;
2017;2º;07808907;ADMINISTRADORA DE CONSORCIOS SICREDI LTDA;Ausência de transparência nas relações contratuais;0;0;1;1;
2017;2º;07808907;ADMINISTRADORA DE CONSORCIOS SICREDI LTDA;Dificuldade na liberação ou substituição de bem;0;0;2;2;
2017;2º;07808907;ADMINISTRADORA DE CONSORCIOS SICREDI LTDA;Insatisfação com a resposta fornecida pela administradora de consórcio relativa à demanda registrada contra ela;0;1;0;1;
2017;2º;07808907;ADMINISTRADORA DE CONSORCIOS SICREDI LTDA;Insatisfação por parte do cliente com o atendimento prestado pela administradora de consórcio;0;0;1;1;
2017;2º;07808907;ADMINISTRADORA DE CONSORCIOS SICREDI LTDA;Irregularidades relacionadas à liberação do crédito;0;2;0;2;
2017;2º;07808907;ADMINISTRADORA DE CONSORCIOS SICREDI LTDA;Prestação inadequada/insuficiente de informação;0;0;1;1;
2017;2º;73230674;ADMINISTRADORA DE CONSÓRCIO RCI BRASIL LTDA;Ausência de transparência nas relações contratuais;0;0;1;1;
2017;2º;73230674;ADMINISTRADORA DE CONSÓRCIO RCI BRASIL LTDA;Descumprimento de cláusulas referentes à devolução de valores;0;2;0;2;
2017;2º;73230674;ADMINISTRADORA DE CONSÓRCIO RCI BRASIL LTDA;Descumprimento de obrigações previstas em contratos;0;2;0;2;
2017;2º;73230674;ADMINISTRADORA DE CONSÓRCIO RCI BRASIL LTDA;Irregularidades relacionadas à liberação do crédito;0;2;0;2;
2017;2º;03765340;ADMINISTRADORA DE CONSÓRCIO REGIONAL WAY LTDA.;Ausência de transparência nas relações contratuais;0;0;1;1;
2017;2º;03765340;ADMINISTRADORA DE CONSÓRCIO REGIONAL WAY LTDA.;Prestação inadequada/insuficiente de informação;0;0;1;1;
2017;2º;03765340;ADMINISTRADORA DE CONSÓRCIO REGIONAL WAY LTDA.;Publicidade enganosa;0;0;2;2;
2017;2º;91341925;ADMINISTRADORA DE CONSÓRCIO SPENGLER LTDA.;Prestação inadequada/insuficiente de informação;0;0;1;1;
2017;2º;94187879;AGIPLAN ADMINISTRADORA DE CONSÓRCIOS LTDA;Ausência de transparência nas relações contratuais;0;0;2;2;
2017;2º;94187879;AGIPLAN ADMINISTRADORA DE CONSÓRCIOS LTDA;Irregularidades relacionadas à liberação do crédito;0;1;0;1;
2017;2º;60375243;ANCORA ADMINISTRADORA DE CONSORCIOS S.A.;Descumprimento de cláusulas referentes à devolução de valores;0;1;0;1;
2017;2º;60375243;ANCORA ADMINISTRADORA DE CONSORCIOS S.A.;Descumprimento de obrigações previstas em contratos;0;1;0;1;
2017;2º;60375243;ANCORA ADMINISTRADORA DE CONSORCIOS S.A.;Dificuldade na liberação ou substituição de bem;0;0;1;1;
2017;2º;60375243;ANCORA ADMINISTRADORA DE CONSORCIOS S.A.;Insatisfação com a resposta fornecida pela administradora de consórcio relativa à demanda registrada contra ela;0;1;0;1;
2017;2º;60375243;ANCORA ADMINISTRADORA DE CONSORCIOS S.A.;Irregularidades relacionadas às condições para contemplação por lance ou sorteio;0;1;0;1;
2017;2º;60375243;ANCORA ADMINISTRADORA DE CONSORCIOS S.A.;Outras irregularidades;0;2;0;2;
2017;2º;71045363;BAMAQ ADMINISTRADORA DE CONSÓRCIOS LTDA;Dificuldade na liberação ou substituição de bem;0;0;1;1;
2017;2º;71045363;BAMAQ ADMINISTRADORA DE CONSÓRCIOS LTDA;Não fornecimento, remessa ou divulgação de documentos obrigatórios;0;1;0;1;
2017;2º;71045363;BAMAQ ADMINISTRADORA DE CONSÓRCIOS LTDA;Prestação inadequada/insuficiente de informação;0;0;3;3;
2017;2º;02010478;BANCORBRÁS ADMINISTRADORA DE CONSÓRCIOS S.A.;Descumprimento de prazo de resposta a demanda;0;1;0;1;
2017;2º;02010478;BANCORBRÁS ADMINISTRADORA DE CONSÓRCIOS S.A.;Insatisfação com a resposta fornecida pela administradora de consórcio relativa à demanda registrada contra ela;0;1;0;1;
2017;2º;02010478;BANCORBRÁS ADMINISTRADORA DE CONSÓRCIOS S.A.;Irregularidades relacionadas à liberação do crédito;0;1;0;1;
2017;2º;02010478;BANCORBRÁS ADMINISTRADORA DE CONSÓRCIOS S.A.;Irregularidades relacionadas às condições para contemplação por lance ou sorteio;0;1;0;1;
2017;2º;02010478;BANCORBRÁS ADMINISTRADORA DE CONSÓRCIOS S.A.;Outras irregularidades;1;0;0;1;
2017;2º;02010478;BANCORBRÁS ADMINISTRADORA DE CONSÓRCIOS S.A.;Prestação inadequada/insuficiente de informação;0;0;6;6;
2017;2º;92692979;BANRISUL S.A. - ADMINISTRADORA DE CONSÓRCIOS;Descumprimento de cláusulas referentes à devolução de valores;0;2;0;2;
2017;2º;92692979;BANRISUL S.A. - ADMINISTRADORA DE CONSÓRCIOS;Descumprimento de obrigações previstas em contratos;0;1;0;1;
2017;2º;92692979;BANRISUL S.A. - ADMINISTRADORA DE CONSÓRCIOS;Irregularidades relacionadas às condições para contemplação por lance ou sorteio;0;1;0;1;
2017;2º;06043050;BB ADMINISTRADORA DE CONSORCIOS S.A.;Ausência de transparência nas relações contratuais;0;0;12;12;
2017;2º;06043050;BB ADMINISTRADORA DE CONSORCIOS S.A.;Descumprimento de cláusulas referentes à devolução de valores;3;16;0;19;
2017;2º;06043050;BB ADMINISTRADORA DE CONSORCIOS S.A.;Descumprimento de obrigações previstas em contratos;4;10;0;14;
2017;2º;06043050;BB ADMINISTRADORA DE CONSORCIOS S.A.;Descumprimento de prazo de resposta a demanda;0;1;0;1;
2017;2º;06043050;BB ADMINISTRADORA DE CONSORCIOS S.A.;Dificuldade na liberação ou substituição de bem;0;0;8;8;
2017;2º;06043050;BB ADMINISTRADORA DE CONSORCIOS S.A.;Insatisfação com a resposta fornecida pela administradora de consórcio relativa à demanda registrada contra ela;1;4;0;5;
2017;2º;06043050;BB ADMINISTRADORA DE CONSORCIOS S.A.;Insatisfação por parte do cliente com o atendimento prestado pela administradora de consórcio;0;0;6;6;
2017;2º;06043050;BB ADMINISTRADORA DE CONSORCIOS S.A.;Irregularidades relacionadas à liberação do crédito;3;30;0;33;
2017;2º;06043050;BB ADMINISTRADORA DE CONSORCIOS S.A.;Prestação inadequada/insuficiente de informação;0;0;15;15;
2017;2º;06043050;BB ADMINISTRADORA DE CONSORCIOS S.A.;Reclamações relacionadas a assuntos diversos;0;0;9;9;
2017;2º;06043050;BB ADMINISTRADORA DE CONSORCIOS S.A.;Recusa ou demora no fornecimento de documentos (exceto demonstrativos obrigatórios);0;0;15;15;
2017;2º;14723388;BR CONSÓRCIOS ADMINISTRADORA DE CONSÓRCIOS LTDA;Ausência de transparência nas relações contratuais;0;0;2;2;
2017;2º;14723388;BR CONSÓRCIOS ADMINISTRADORA DE CONSÓRCIOS LTDA;Descumprimento de cláusulas referentes à devolução de valores;0;1;0;1;
2017;2º;14723388;BR CONSÓRCIOS ADMINISTRADORA DE CONSÓRCIOS LTDA;Descumprimento de obrigações previstas em contratos;0;4;0;4;
2017;2º;14723388;BR CONSÓRCIOS ADMINISTRADORA DE CONSÓRCIOS LTDA;Dificuldade na liberação ou substituição de bem;0;0;2;2;
2017;2º;14723388;BR CONSÓRCIOS ADMINISTRADORA DE CONSÓRCIOS LTDA;Insatisfação por parte do cliente com o atendimento prestado pela administradora de consórcio;0;0;1;1;
2017;2º;14723388;BR CONSÓRCIOS ADMINISTRADORA DE CONSÓRCIOS LTDA;Irregularidades relacionadas à liberação do crédito;0;1;0;1;
2017;2º;14723388;BR CONSÓRCIOS ADMINISTRADORA DE CONSÓRCIOS LTDA;Prestação inadequada/insuficiente de informação;0;0;4;4;
2017;2º;14723388;BR CONSÓRCIOS ADMINISTRADORA DE CONSÓRCIOS LTDA;Publicidade enganosa;0;0;1;1;
2017;2º;14723388;BR CONSÓRCIOS ADMINISTRADORA DE CONSÓRCIOS LTDA;Reclamações relacionadas a assuntos diversos;0;0;5;5;
2017;2º;14723388;BR CONSÓRCIOS ADMINISTRADORA DE CONSÓRCIOS LTDA;Recusa ou demora no fornecimento de documentos (exceto demonstrativos obrigatórios);0;0;7;7;
2017;2º;52568821;BRADESCO ADMINISTRADORA DE CONSÓRCIOS LTDA.;Ausência de transparência nas relações contratuais;0;0;2;2;
2017;2º;52568821;BRADESCO ADMINISTRADORA DE CONSÓRCIOS LTDA.;Cobrança irregular de tarifa pela emissão de boletos, carnês e assemelhados;0;6;0;6;
2017;2º;52568821;BRADESCO ADMINISTRADORA DE CONSÓRCIOS LTDA.;Descumprimento de cláusulas referentes à devolução de valores;1;81;0;82;
2017;2º;52568821;BRADESCO ADMINISTRADORA DE CONSÓRCIOS LTDA.;Descumprimento de obrigações previstas em contratos;7;96;0;103;
2017;2º;52568821;BRADESCO ADMINISTRADORA DE CONSÓRCIOS LTDA.;Descumprimento de prazo de resposta a demanda;1;13;0;14;
2017;2º;52568821;BRADESCO ADMINISTRADORA DE CONSÓRCIOS LTDA.;Descumprimento de prazo para apresentação de resposta conclusiva pela Ouvidoria;0;4;0;4;
2017;2º;52568821;BRADESCO ADMINISTRADORA DE CONSÓRCIOS LTDA.;Dificuldade na liberação ou substituição de bem;0;0;98;98;
2017;2º;52568821;BRADESCO ADMINISTRADORA DE CONSÓRCIOS LTDA.;Insatisfação com a resposta fornecida pela administradora de consórcio relativa à demanda registrada contra ela;6;52;0;58;
2017;2º;52568821;BRADESCO ADMINISTRADORA DE CONSÓRCIOS LTDA.;Insatisfação por parte do cliente com o atendimento prestado pela administradora de consórcio;0;0;198;198;
2017;2º;52568821;BRADESCO ADMINISTRADORA DE CONSÓRCIOS LTDA.;Irregularidades relacionadas à liberação do crédito;4;208;0;212;
2017;2º;52568821;BRADESCO ADMINISTRADORA DE CONSÓRCIOS LTDA.;Irregularidades relacionadas às condições para contemplação por lance ou sorteio;0;13;0;13;
2017;2º;52568821;BRADESCO ADMINISTRADORA DE CONSÓRCIOS LTDA.;Não fornecimento, remessa ou divulgação de documentos obrigatórios;0;5;0;5;
2017;2º;52568821;BRADESCO ADMINISTRADORA DE CONSÓRCIOS LTDA.;Outras irregularidades;0;5;0;5;
2017;2º;52568821;BRADESCO ADMINISTRADORA DE CONSÓRCIOS LTDA.;Outras irregularidades relacionadas à Ouvidoria;0;1;0;1;
2017;2º;52568821;BRADESCO ADMINISTRADORA DE CONSÓRCIOS LTDA.;Prestação inadequada/insuficiente de informação;0;0;147;147;
2017;2º;52568821;BRADESCO ADMINISTRADORA DE CONSÓRCIOS LTDA.;Publicidade enganosa;0;0;2;2;
2017;2º;52568821;BRADESCO ADMINISTRADORA DE CONSÓRCIOS LTDA.;Reclamações relacionadas a assuntos diversos;0;0;46;46;
2017;2º;52568821;BRADESCO ADMINISTRADORA DE CONSÓRCIOS LTDA.;Recusa ou demora no fornecimento de documentos (exceto demonstrativos obrigatórios);0;0;51;51;
2017;2º;73235962;BREITKOPF ADMINISTRADORA DE CONSÓRCIO LTDA.;Prestação inadequada/insuficiente de informação;0;0;1;1;
2017;2º;06046109;BRISA ADMINISTRADORA DE CONSORCIOS LTDA;Insatisfação por parte do cliente com o atendimento prestado pela administradora de consórcio;0;0;1;1;
2017;2º;45713971;BRQUALY ADMINISTRADORA DE CONSÓRCIOS LTDA.;Descumprimento de cláusulas referentes à devolução de valores;0;1;0;1;
2017;2º;45713971;BRQUALY ADMINISTRADORA DE CONSÓRCIOS LTDA.;Insatisfação com a resposta fornecida pela administradora de consórcio relativa à demanda registrada contra ela;0;2;0;2;
2017;2º;45713971;BRQUALY ADMINISTRADORA DE CONSÓRCIOS LTDA.;Irregularidades relacionadas às condições para contemplação por lance ou sorteio;0;1;0;1;
2017;2º;45713971;BRQUALY ADMINISTRADORA DE CONSÓRCIOS LTDA.;Não fornecimento, remessa ou divulgação de documentos obrigatórios;1;0;0;1;
2017;2º;45713971;BRQUALY ADMINISTRADORA DE CONSÓRCIOS LTDA.;Reclamações relacionadas a assuntos diversos;0;0;1;1;
2017;2º;45713971;BRQUALY ADMINISTRADORA DE CONSÓRCIOS LTDA.;Recusa ou demora no fornecimento de documentos (exceto demonstrativos obrigatórios);0;0;1;1;
2017;2º;05349595;CAIXA CONSÓRCIOS S.A ADMINISTRADORA DE CONSÓRCIOS;Ausência de informações/cláusulas obrigatórias em contrato;2;0;0;2;
2017;2º;05349595;CAIXA CONSÓRCIOS S.A ADMINISTRADORA DE CONSÓRCIOS;Ausência de transparência nas relações contratuais;0;0;2;2;
2017;2º;05349595;CAIXA CONSÓRCIOS S.A ADMINISTRADORA DE CONSÓRCIOS;Descumprimento de cláusulas referentes à devolução de valores;0;12;0;12;
2017;2º;05349595;CAIXA CONSÓRCIOS S.A ADMINISTRADORA DE CONSÓRCIOS;Descumprimento de obrigações previstas em contratos;7;15;0;22;
2017;2º;05349595;CAIXA CONSÓRCIOS S.A ADMINISTRADORA DE CONSÓRCIOS;Descumprimento de prazo de resposta a demanda;0;5;0;5;
2017;2º;05349595;CAIXA CONSÓRCIOS S.A ADMINISTRADORA DE CONSÓRCIOS;Dificuldade na liberação ou substituição de bem;0;0;4;4;
2017;2º;05349595;CAIXA CONSÓRCIOS S.A ADMINISTRADORA DE CONSÓRCIOS;Insatisfação com a resposta fornecida pela administradora de consórcio relativa à demanda registrada contra ela;0;10;0;10;
2017;2º;05349595;CAIXA CONSÓRCIOS S.A ADMINISTRADORA DE CONSÓRCIOS;Insatisfação por parte do cliente com o atendimento prestado pela administradora de consórcio;0;0;25;25;
2017;2º;05349595;CAIXA CONSÓRCIOS S.A ADMINISTRADORA DE CONSÓRCIOS;Irregularidades relacionadas à liberação do crédito;4;48;0;52;
2017;2º;05349595;CAIXA CONSÓRCIOS S.A ADMINISTRADORA DE CONSÓRCIOS;Irregularidades relacionadas às condições para contemplação por lance ou sorteio;1;4;0;5;
2017;2º;05349595;CAIXA CONSÓRCIOS S.A ADMINISTRADORA DE CONSÓRCIOS;Não fornecimento, remessa ou divulgação de documentos obrigatórios;1;0;0;1;
2017;2º;05349595;CAIXA CONSÓRCIOS S.A ADMINISTRADORA DE CONSÓRCIOS;Operações de entidades não fiscalizadas pelo Banco Central;0;0;1;1;
2017;2º;05349595;CAIXA CONSÓRCIOS S.A ADMINISTRADORA DE CONSÓRCIOS;Outras irregularidades;1;9;0;10;
2017;2º;05349595;CAIXA CONSÓRCIOS S.A ADMINISTRADORA DE CONSÓRCIOS;Prestação inadequada/insuficiente de informação;0;0;3;3;
2017;2º;05349595;CAIXA CONSÓRCIOS S.A ADMINISTRADORA DE CONSÓRCIOS;Publicidade enganosa;0;0;2;2;
2017;2º;05349595;CAIXA CONSÓRCIOS S.A ADMINISTRADORA DE CONSÓRCIOS;Reclamações relacionadas a assuntos diversos;0;0;17;17;
2017;2º;05349595;CAIXA CONSÓRCIOS S.A ADMINISTRADORA DE CONSÓRCIOS;Recusa ou demora no fornecimento de documentos (exceto demonstrativos obrigatórios);0;0;12;12;
2017;2º;68318773;CANOPUS ADMINISTRADORA DE CONSORCIOS S/A;Ausência de transparência nas relações contratuais;0;0;2;2;
2017;2º;68318773;CANOPUS ADMINISTRADORA DE CONSORCIOS S/A;Descumprimento de cláusulas referentes à devolução de valores;0;2;0;2;
2017;2º;68318773;CANOPUS ADMINISTRADORA DE CONSORCIOS S/A;Insatisfação com a resposta fornecida pela administradora de consórcio relativa à demanda registrada contra ela;0;1;0;1;
2017;2º;68318773;CANOPUS ADMINISTRADORA DE CONSORCIOS S/A;Insatisfação por parte do cliente com o atendimento prestado pela administradora de consórcio;0;0;1;1;
2017;2º;68318773;CANOPUS ADMINISTRADORA DE CONSORCIOS S/A;Irregularidades relacionadas à liberação do crédito;0;2;0;2;
2017;2º;68318773;CANOPUS ADMINISTRADORA DE CONSORCIOS S/A;Outras irregularidades;0;1;0;1;
2017;2º;68318773;CANOPUS ADMINISTRADORA DE CONSORCIOS S/A;Publicidade enganosa;0;0;1;1;
2017;2º;00266031;CICAL ADMINISTRADORA DE CONSÓRCIOS LTDA;Publicidade enganosa;0;0;1;1;
2017;2º;13170428;CIMAVEL ADMINISTRADORA DE CONSÓRCIO LTDA.;Descumprimento de obrigações previstas em contratos;0;1;0;1;
2017;2º;13170428;CIMAVEL ADMINISTRADORA DE CONSÓRCIO LTDA.;Irregularidades relacionadas às condições para contemplação por lance ou sorteio;0;1;0;1;
2017;2º;59129403;CNF - ADMINISTRADORA DE CONSÓRCIOS NACIONAL LTDA.;Descumprimento de prazo de resposta a demanda;0;1;0;1;
2017;2º;59129403;CNF - ADMINISTRADORA DE CONSÓRCIOS NACIONAL LTDA.;Insatisfação com a resposta fornecida pela administradora de consórcio relativa à demanda registrada contra ela;0;1;0;1;
2017;2º;59129403;CNF - ADMINISTRADORA DE CONSÓRCIOS NACIONAL LTDA.;Insatisfação por parte do cliente com o atendimento prestado pela administradora de consórcio;0;0;4;4;
2017;2º;59129403;CNF - ADMINISTRADORA DE CONSÓRCIOS NACIONAL LTDA.;Irregularidades relacionadas à liberação do crédito;0;1;0;1;
2017;2º;59129403;CNF - ADMINISTRADORA DE CONSÓRCIOS NACIONAL LTDA.;Irregularidades relacionadas às condições para contemplação por lance ou sorteio;0;1;0;1;
2017;2º;59129403;CNF - ADMINISTRADORA DE CONSÓRCIOS NACIONAL LTDA.;Outras irregularidades;0;1;0;1;
2017;2º;59129403;CNF - ADMINISTRADORA DE CONSÓRCIOS NACIONAL LTDA.;Recusa ou demora no fornecimento de documentos (exceto demonstrativos obrigatórios);0;0;1;1;
2017;2º;62798475;CNK ADMINISTRADORA DE CONSÓRCIO LTDA.;Descumprimento de cláusulas referentes à devolução de valores;0;1;0;1;
2017;2º;81742223;CONSEG ADMINISTRADORA DE CONSÓRCIOS S/A;Dificuldade na liberação ou substituição de bem;0;0;1;1;
2017;2º;81742223;CONSEG ADMINISTRADORA DE CONSÓRCIOS S/A;Insatisfação com a resposta fornecida pela administradora de consórcio relativa à demanda registrada contra ela;0;1;0;1;
2017;2º;81742223;CONSEG ADMINISTRADORA DE CONSÓRCIOS S/A;Insatisfação por parte do cliente com o atendimento prestado pela administradora de consórcio;0;0;1;1;
2017;2º;81742223;CONSEG ADMINISTRADORA DE CONSÓRCIOS S/A;Prestação inadequada/insuficiente de informação;0;0;2;2;
2017;2º;81742223;CONSEG ADMINISTRADORA DE CONSÓRCIOS S/A;Reclamações relacionadas a assuntos diversos;0;0;1;1;
2017;2º;81742223;CONSEG ADMINISTRADORA DE CONSÓRCIOS S/A;Recusa ou demora no fornecimento de documentos (exceto demonstrativos obrigatórios);0;0;1;1;
2017;2º;44196293;CONSHOP ADMINISTRADORA DE CONSORCIOS LTDA.;Ausência de transparência nas relações contratuais;0;0;1;1;
2017;2º;44196293;CONSHOP ADMINISTRADORA DE CONSORCIOS LTDA.;Descumprimento de cláusulas referentes à devolução de valores;0;1;0;1;
2017;2º;47658539;CONSÓRCIO NACIONAL VOLKSWAGEN - ADMINISTRADORA DE CONSÓRCIO LTDA.;Ausência de transparência nas relações contratuais;0;0;13;13;
2017;2º;47658539;CONSÓRCIO NACIONAL VOLKSWAGEN - ADMINISTRADORA DE CONSÓRCIO LTDA.;Cobrança irregular de tarifa pela emissão de boletos, carnês e assemelhados;2;0;0;2;
2017;2º;47658539;CONSÓRCIO NACIONAL VOLKSWAGEN - ADMINISTRADORA DE CONSÓRCIO LTDA.;Descumprimento de cláusulas referentes à devolução de valores;5;51;0;56;
2017;2º;47658539;CONSÓRCIO NACIONAL VOLKSWAGEN - ADMINISTRADORA DE CONSÓRCIO LTDA.;Descumprimento de obrigações previstas em contratos;3;15;0;18;
2017;2º;47658539;CONSÓRCIO NACIONAL VOLKSWAGEN - ADMINISTRADORA DE CONSÓRCIO LTDA.;Descumprimento de prazo de resposta a demanda;2;0;0;2;
2017;2º;47658539;CONSÓRCIO NACIONAL VOLKSWAGEN - ADMINISTRADORA DE CONSÓRCIO LTDA.;Dificuldade na liberação ou substituição de bem;0;0;6;6;
2017;2º;47658539;CONSÓRCIO NACIONAL VOLKSWAGEN - ADMINISTRADORA DE CONSÓRCIO LTDA.;Insatisfação com a resposta fornecida pela administradora de consórcio relativa à demanda registrada contra ela;1;16;0;17;
2017;2º;47658539;CONSÓRCIO NACIONAL VOLKSWAGEN - ADMINISTRADORA DE CONSÓRCIO LTDA.;Insatisfação por parte do cliente com o atendimento prestado pela administradora de consórcio;0;0;11;11;
2017;2º;47658539;CONSÓRCIO NACIONAL VOLKSWAGEN - ADMINISTRADORA DE CONSÓRCIO LTDA.;Irregularidades relacionadas à liberação do crédito;2;42;0;44;
2017;2º;47658539;CONSÓRCIO NACIONAL VOLKSWAGEN - ADMINISTRADORA DE CONSÓRCIO LTDA.;Irregularidades relacionadas às condições para contemplação por lance ou sorteio;0;9;0;9;
2017;2º;47658539;CONSÓRCIO NACIONAL VOLKSWAGEN - ADMINISTRADORA DE CONSÓRCIO LTDA.;Não fornecimento, remessa ou divulgação de documentos obrigatórios;1;0;0;1;
2017;2º;47658539;CONSÓRCIO NACIONAL VOLKSWAGEN - ADMINISTRADORA DE CONSÓRCIO LTDA.;Outras irregularidades;1;1;0;2;
2017;2º;47658539;CONSÓRCIO NACIONAL VOLKSWAGEN - ADMINISTRADORA DE CONSÓRCIO LTDA.;Prestação inadequada/insuficiente de informação;0;0;9;9;
2017;2º;47658539;CONSÓRCIO NACIONAL VOLKSWAGEN - ADMINISTRADORA DE CONSÓRCIO LTDA.;Publicidade enganosa;0;0;1;1;
2017;2º;47658539;CONSÓRCIO NACIONAL VOLKSWAGEN - ADMINISTRADORA DE CONSÓRCIO LTDA.;Reclamações relacionadas a assuntos diversos;0;0;19;19;
2017;2º;47658539;CONSÓRCIO NACIONAL VOLKSWAGEN - ADMINISTRADORA DE CONSÓRCIO LTDA.;Recusa ou demora no fornecimento de documentos (exceto demonstrativos obrigatórios);0;0;12;12;
2017;2º;80990146;CONTEMPLA ADMINISTRADORA DE CONSORCIO LTDA.;Dificuldade na liberação ou substituição de bem;0;0;1;1;
2017;2º;58919903;CONVEF ADMINISTRADORA DE CONSÓRCIOS LTDA.;Descumprimento de cláusulas referentes à devolução de valores;0;4;0;4;
2017;2º;58919903;CONVEF ADMINISTRADORA DE CONSÓRCIOS LTDA.;Descumprimento de obrigações previstas em contratos;0;1;0;1;
2017;2º;58919903;CONVEF ADMINISTRADORA DE CONSÓRCIOS LTDA.;Dificuldade na liberação ou substituição de bem;0;0;1;1;
2017;2º;58919903;CONVEF ADMINISTRADORA DE CONSÓRCIOS LTDA.;Irregularidades relacionadas à liberação do crédito;0;1;0;1;
2017;2º;58919903;CONVEF ADMINISTRADORA DE CONSÓRCIOS LTDA.;Outras irregularidades;0;1;0;1;
2017;2º;61550836;COOPERATIVA MISTA JOCKEY CLUB DE SAO PAULO;Descumprimento de obrigações previstas em contratos;0;2;0;2;
2017;2º;61550836;COOPERATIVA MISTA JOCKEY CLUB DE SAO PAULO;Descumprimento de prazo de resposta a demanda;2;0;0;2;
2017;2º;61550836;COOPERATIVA MISTA JOCKEY CLUB DE SAO PAULO;Insatisfação com a resposta fornecida pela administradora de consórcio relativa à demanda registrada contra ela;0;4;0;4;
2017;2º;61550836;COOPERATIVA MISTA JOCKEY CLUB DE SAO PAULO;Outras irregularidades;1;41;0;42;
2017;2º;61550836;COOPERATIVA MISTA JOCKEY CLUB DE SAO PAULO;Outras irregularidades relacionadas à Ouvidoria;0;1;0;1;
2017;2º;59395061;DISAL ADMINISTRADORA DE CONSÓRCIOS LTDA;Ausência de informações/cláusulas obrigatórias em contrato;1;0;0;1;
2017;2º;59395061;DISAL ADMINISTRADORA DE CONSÓRCIOS LTDA;Ausência de transparência nas relações contratuais;0;0;2;2;
2017;2º;59395061;DISAL ADMINISTRADORA DE CONSÓRCIOS LTDA;Cobrança irregular de tarifa pela emissão de boletos, carnês e assemelhados;0;2;0;2;
2017;2º;59395061;DISAL ADMINISTRADORA DE CONSÓRCIOS LTDA;Descumprimento de cláusulas referentes à devolução de valores;0;11;0;11;
2017;2º;59395061;DISAL ADMINISTRADORA DE CONSÓRCIOS LTDA;Descumprimento de obrigações previstas em contratos;1;13;0;14;
2017;2º;59395061;DISAL ADMINISTRADORA DE CONSÓRCIOS LTDA;Dificuldade na liberação ou substituição de bem;0;0;2;2;
2017;2º;59395061;DISAL ADMINISTRADORA DE CONSÓRCIOS LTDA;Insatisfação com a resposta fornecida pela administradora de consórcio relativa à demanda registrada contra ela;0;5;0;5;
2017;2º;59395061;DISAL ADMINISTRADORA DE CONSÓRCIOS LTDA;Insatisfação por parte do cliente com o atendimento prestado pela administradora de consórcio;0;0;4;4;
2017;2º;59395061;DISAL ADMINISTRADORA DE CONSÓRCIOS LTDA;Irregularidades relacionadas à liberação do crédito;0;10;0;10;
2017;2º;59395061;DISAL ADMINISTRADORA DE CONSÓRCIOS LTDA;Irregularidades relacionadas às condições para contemplação por lance ou sorteio;0;5;0;5;
2017;2º;59395061;DISAL ADMINISTRADORA DE CONSÓRCIOS LTDA;Outras irregularidades;0;3;0;3;
2017;2º;59395061;DISAL ADMINISTRADORA DE CONSÓRCIOS LTDA;Prestação inadequada/insuficiente de informação;0;0;8;8;
2017;2º;59395061;DISAL ADMINISTRADORA DE CONSÓRCIOS LTDA;Reclamações relacionadas a assuntos diversos;0;0;5;5;
2017;2º;59395061;DISAL ADMINISTRADORA DE CONSÓRCIOS LTDA;Recusa ou demora no fornecimento de documentos (exceto demonstrativos obrigatórios);0;0;2;2;
2017;2º;08570707;ELDORADO ADMINISTRADORA DE CONSORCIO LTDA;Irregularidades relacionadas à liberação do crédito;0;1;0;1;
2017;2º;58113812;EMBRACON ADMINISTRADORA DE CONSÓRCIO LTDA;Ausência de transparência nas relações contratuais;0;0;8;8;
2017;2º;58113812;EMBRACON ADMINISTRADORA DE CONSÓRCIO LTDA;Cobrança irregular de tarifa pela emissão de boletos, carnês e assemelhados;0;1;0;1;
2017;2º;58113812;EMBRACON ADMINISTRADORA DE CONSÓRCIO LTDA;Descumprimento de cláusulas referentes à devolução de valores;0;18;0;18;
2017;2º;58113812;EMBRACON ADMINISTRADORA DE CONSÓRCIO LTDA;Descumprimento de obrigações previstas em contratos;2;12;0;14;
2017;2º;58113812;EMBRACON ADMINISTRADORA DE CONSÓRCIO LTDA;Descumprimento de prazo de resposta a demanda;0;1;0;1;
2017;2º;58113812;EMBRACON ADMINISTRADORA DE CONSÓRCIO LTDA;Dificuldade na liberação ou substituição de bem;0;0;1;1;
2017;2º;58113812;EMBRACON ADMINISTRADORA DE CONSÓRCIO LTDA;Insatisfação com a resposta fornecida pela administradora de consórcio relativa à demanda registrada contra ela;0;17;0;17;
2017;2º;58113812;EMBRACON ADMINISTRADORA DE CONSÓRCIO LTDA;Insatisfação por parte do cliente com o atendimento prestado pela administradora de consórcio;0;0;13;13;
2017;2º;58113812;EMBRACON ADMINISTRADORA DE CONSÓRCIO LTDA;Irregularidades relacionadas à liberação do crédito;0;24;0;24;
2017;2º;58113812;EMBRACON ADMINISTRADORA DE CONSÓRCIO LTDA;Irregularidades relacionadas às condições para contemplação por lance ou sorteio;0;6;0;6;
2017;2º;58113812;EMBRACON ADMINISTRADORA DE CONSÓRCIO LTDA;Outras irregularidades;0;2;0;2;
2017;2º;58113812;EMBRACON ADMINISTRADORA DE CONSÓRCIO LTDA;Prestação inadequada/insuficiente de informação;0;0;43;43;
2017;2º;58113812;EMBRACON ADMINISTRADORA DE CONSÓRCIO LTDA;Publicidade enganosa;0;0;16;16;
2017;2º;58113812;EMBRACON ADMINISTRADORA DE CONSÓRCIO LTDA;Reclamações relacionadas a assuntos diversos;0;0;5;5;
2017;2º;58113812;EMBRACON ADMINISTRADORA DE CONSÓRCIO LTDA;Recusa ou demora no fornecimento de documentos (exceto demonstrativos obrigatórios);0;0;13;13;
2017;2º;91107581;FARROUPILHA ADMINISTRADORA DE CONSÓRCIOS LTDA.;Prestação inadequada/insuficiente de informação;0;0;2;2;
2017;2º;78688462;FIPAL ADMINISTRADORA DE CONSÓRCIOS LTDA;Dificuldade na liberação ou substituição de bem;0;0;1;1;
2017;2º;00643742;FUNDACAO HABITACIONAL DO EXERCITO - FHE;Descumprimento de cláusulas referentes à devolução de valores;0;1;0;1;
2017;2º;00643742;FUNDACAO HABITACIONAL DO EXERCITO - FHE;Descumprimento de obrigações previstas em contratos;1;0;0;1;
2017;2º;00643742;FUNDACAO HABITACIONAL DO EXERCITO - FHE;Insatisfação por parte do cliente com o atendimento prestado pela administradora de consórcio;0;0;2;2;
2017;2º;00643742;FUNDACAO HABITACIONAL DO EXERCITO - FHE;Prestação inadequada/insuficiente de informação;0;0;2;2;
2017;2º;00643742;FUNDACAO HABITACIONAL DO EXERCITO - FHE;Reclamações relacionadas a assuntos diversos;0;0;5;5;
2017;2º;00643742;FUNDACAO HABITACIONAL DO EXERCITO - FHE;Recusa ou demora no fornecimento de documentos (exceto demonstrativos obrigatórios);0;0;1;1;
2017;2º;47820097;GAPLAN ADMINISTRADORA DE CONSÓRCIO LTDA.;Descumprimento de cláusulas referentes à devolução de valores;0;1;0;1;
2017;2º;85322204;GLOBO ADMINISTRADORA DE CONSÓRCIOS LTDA.;Descumprimento de cláusulas referentes à devolução de valores;0;2;0;2;
2017;2º;85322204;GLOBO ADMINISTRADORA DE CONSÓRCIOS LTDA.;Descumprimento de obrigações previstas em contratos;0;1;0;1;
2017;2º;49937055;GMAC ADMINISTRADORA DE CONSORCIOS LTDA;Ausência de informações/cláusulas obrigatórias em contrato;0;1;0;1;
2017;2º;49937055;GMAC ADMINISTRADORA DE CONSORCIOS LTDA;Ausência de transparência nas relações contratuais;0;0;2;2;
2017;2º;49937055;GMAC ADMINISTRADORA DE CONSORCIOS LTDA;Descumprimento de cláusulas referentes à devolução de valores;2;10;0;12;
2017;2º;49937055;GMAC ADMINISTRADORA DE CONSORCIOS LTDA;Descumprimento de obrigações previstas em contratos;0;5;0;5;
2017;2º;49937055;GMAC ADMINISTRADORA DE CONSORCIOS LTDA;Dificuldade na liberação ou substituição de bem;0;0;9;9;
2017;2º;49937055;GMAC ADMINISTRADORA DE CONSORCIOS LTDA;Insatisfação com a resposta fornecida pela administradora de consórcio relativa à demanda registrada contra ela;0;6;0;6;
2017;2º;49937055;GMAC ADMINISTRADORA DE CONSORCIOS LTDA;Insatisfação por parte do cliente com o atendimento prestado pela administradora de consórcio;0;0;7;7;
2017;2º;49937055;GMAC ADMINISTRADORA DE CONSORCIOS LTDA;Irregularidades relacionadas à liberação do crédito;2;19;0;21;
2017;2º;49937055;GMAC ADMINISTRADORA DE CONSORCIOS LTDA;Irregularidades relacionadas às condições para contemplação por lance ou sorteio;0;2;0;2;
2017;2º;49937055;GMAC ADMINISTRADORA DE CONSORCIOS LTDA;Prestação inadequada/insuficiente de informação;0;0;4;4;
2017;2º;49937055;GMAC ADMINISTRADORA DE CONSORCIOS LTDA;Reclamações relacionadas a assuntos diversos;0;0;6;6;
2017;2º;49937055;GMAC ADMINISTRADORA DE CONSORCIOS LTDA;Recusa ou demora no fornecimento de documentos (exceto demonstrativos obrigatórios);0;0;12;12;
2017;2º;02798858;GOVESA ADMINISTRADORA DE CONSÓRCIOS LTDA;Descumprimento de cláusulas referentes à devolução de valores;0;1;0;1;
2017;2º;02798858;GOVESA ADMINISTRADORA DE CONSÓRCIOS LTDA;Irregularidades relacionadas à liberação do crédito;0;1;0;1;
2017;2º;02798858;GOVESA ADMINISTRADORA DE CONSÓRCIOS LTDA;Irregularidades relacionadas às condições para contemplação por lance ou sorteio;0;1;0;1;
2017;2º;26228270;GROSCON ADMINISTRADORA DE CONSORCIOS LTDA.;Descumprimento de cláusulas referentes à devolução de valores;0;1;0;1;
2017;2º;26228270;GROSCON ADMINISTRADORA DE CONSORCIOS LTDA.;Outras irregularidades;0;1;0;1;
2017;2º;26253658;GUARAPIRANGA VEÍCULOS ADMINISTRADORA DE CONSÓRCIOS LTDA.;Descumprimento de obrigações previstas em contratos;0;1;0;1;
2017;2º;03586655;H. ADMINISTRADORA DE CONSÓRCIOS LTDA;Descumprimento de cláusulas referentes à devolução de valores;0;1;0;1;
2017;2º;73516106;HS ADMINISTRADORA DE CONSÓRCIOS LTDA;Irregularidades relacionadas à liberação do crédito;0;2;0;2;
2017;2º;73516106;HS ADMINISTRADORA DE CONSÓRCIOS LTDA;Prestação inadequada/insuficiente de informação;0;0;2;2;
2017;2º;06181431;ITAUNA ADMINISTRADORA DE CONSORCIO LTDA;Descumprimento de cláusulas referentes à devolução de valores;0;1;0;1;
2017;2º;06181431;ITAUNA ADMINISTRADORA DE CONSORCIO LTDA;Irregularidades relacionadas à liberação do crédito;0;1;0;1;
2017;2º;06181431;ITAUNA ADMINISTRADORA DE CONSORCIO LTDA;Prestação inadequada/insuficiente de informação;0;0;1;1;
2017;2º;00000776;ITAÚ ADMINISTRADORA DE CONSÓRCIOS LTDA.;Ausência de transparência nas relações contratuais;0;0;10;10;
2017;2º;00000776;ITAÚ ADMINISTRADORA DE CONSÓRCIOS LTDA.;Cobrança irregular de tarifa pela emissão de boletos, carnês e assemelhados;0;5;0;5;
2017;2º;00000776;ITAÚ ADMINISTRADORA DE CONSÓRCIOS LTDA.;Descumprimento de cláusulas referentes à devolução de valores;1;27;0;28;
2017;2º;00000776;ITAÚ ADMINISTRADORA DE CONSÓRCIOS LTDA.;Descumprimento de obrigações previstas em contratos;4;19;0;23;
2017;2º;00000776;ITAÚ ADMINISTRADORA DE CONSÓRCIOS LTDA.;Descumprimento de prazo de resposta a demanda;2;5;0;7;
2017;2º;00000776;ITAÚ ADMINISTRADORA DE CONSÓRCIOS LTDA.;Dificuldade na liberação ou substituição de bem;0;0;15;15;
2017;2º;00000776;ITAÚ ADMINISTRADORA DE CONSÓRCIOS LTDA.;Insatisfação com a resposta fornecida pela administradora de consórcio relativa à demanda registrada contra ela;3;10;0;13;
2017;2º;00000776;ITAÚ ADMINISTRADORA DE CONSÓRCIOS LTDA.;Insatisfação por parte do cliente com o atendimento prestado pela administradora de consórcio;0;0;26;26;
2017;2º;00000776;ITAÚ ADMINISTRADORA DE CONSÓRCIOS LTDA.;Irregularidades relacionadas à liberação do crédito;0;70;0;70;
2017;2º;00000776;ITAÚ ADMINISTRADORA DE CONSÓRCIOS LTDA.;Irregularidades relacionadas às condições para contemplação por lance ou sorteio;1;9;0;10;
2017;2º;00000776;ITAÚ ADMINISTRADORA DE CONSÓRCIOS LTDA.;Não fornecimento, remessa ou divulgação de documentos obrigatórios;0;2;0;2;
2017;2º;00000776;ITAÚ ADMINISTRADORA DE CONSÓRCIOS LTDA.;Outras irregularidades;1;1;0;2;
2017;2º;00000776;ITAÚ ADMINISTRADORA DE CONSÓRCIOS LTDA.;Prestação inadequada/insuficiente de informação;0;0;29;29;
2017;2º;00000776;ITAÚ ADMINISTRADORA DE CONSÓRCIOS LTDA.;Publicidade enganosa;0;0;3;3;
2017;2º;00000776;ITAÚ ADMINISTRADORA DE CONSÓRCIOS LTDA.;Reclamações relacionadas a assuntos diversos;0;0;43;43;
2017;2º;00000776;ITAÚ ADMINISTRADORA DE CONSÓRCIOS LTDA.;Recusa ou demora no fornecimento de documentos (exceto demonstrativos obrigatórios);0;0;5;5;
2017;2º;42421776;ITAÚ UNIBANCO VEÍCULOS ADMINISTRADORA DE CONSÓRCIOS LTDA.;Cobrança irregular de tarifa pela emissão de boletos, carnês e assemelhados;0;1;0;1;
2017;2º;42421776;ITAÚ UNIBANCO VEÍCULOS ADMINISTRADORA DE CONSÓRCIOS LTDA.;Descumprimento de cláusulas referentes à devolução de valores;0;5;0;5;
2017;2º;42421776;ITAÚ UNIBANCO VEÍCULOS ADMINISTRADORA DE CONSÓRCIOS LTDA.;Descumprimento de obrigações previstas em contratos;1;0;0;1;
2017;2º;42421776;ITAÚ UNIBANCO VEÍCULOS ADMINISTRADORA DE CONSÓRCIOS LTDA.;Dificuldade na liberação ou substituição de bem;0;0;4;4;
2017;2º;42421776;ITAÚ UNIBANCO VEÍCULOS ADMINISTRADORA DE CONSÓRCIOS LTDA.;Insatisfação com a resposta fornecida pela administradora de consórcio relativa à demanda registrada contra ela;1;4;0;5;
2017;2º;42421776;ITAÚ UNIBANCO VEÍCULOS ADMINISTRADORA DE CONSÓRCIOS LTDA.;Insatisfação por parte do cliente com o atendimento prestado pela administradora de consórcio;0;0;5;5;
2017;2º;42421776;ITAÚ UNIBANCO VEÍCULOS ADMINISTRADORA DE CONSÓRCIOS LTDA.;Irregularidades relacionadas à liberação do crédito;0;14;0;14;
2017;2º;42421776;ITAÚ UNIBANCO VEÍCULOS ADMINISTRADORA DE CONSÓRCIOS LTDA.;Prestação inadequada/insuficiente de informação;0;0;8;8;
2017;2º;42421776;ITAÚ UNIBANCO VEÍCULOS ADMINISTRADORA DE CONSÓRCIOS LTDA.;Publicidade enganosa;0;0;1;1;
2017;2º;42421776;ITAÚ UNIBANCO VEÍCULOS ADMINISTRADORA DE CONSÓRCIOS LTDA.;Reclamações relacionadas a assuntos diversos;0;0;17;17;
2017;2º;42421776;ITAÚ UNIBANCO VEÍCULOS ADMINISTRADORA DE CONSÓRCIOS LTDA.;Recusa ou demora no fornecimento de documentos (exceto demonstrativos obrigatórios);0;0;3;3;
2017;2º;60250776;LUIZA ADMINISTRADORA DE CONSÓRCIOS LTDA;Descumprimento de cláusulas referentes à devolução de valores;0;8;0;8;
2017;2º;60250776;LUIZA ADMINISTRADORA DE CONSÓRCIOS LTDA;Descumprimento de obrigações previstas em contratos;0;1;0;1;
2017;2º;60250776;LUIZA ADMINISTRADORA DE CONSÓRCIOS LTDA;Insatisfação com a resposta fornecida pela administradora de consórcio relativa à demanda registrada contra ela;0;1;0;1;
2017;2º;60250776;LUIZA ADMINISTRADORA DE CONSÓRCIOS LTDA;Não fornecimento, remessa ou divulgação de documentos obrigatórios;0;1;0;1;
2017;2º;60250776;LUIZA ADMINISTRADORA DE CONSÓRCIOS LTDA;Outras irregularidades;0;1;0;1;
2017;2º;04250224;MAGGI ADMINISTRADORA DE CONSÓRCIOS LTDA;Descumprimento de obrigações previstas em contratos;0;1;0;1;
2017;2º;04250224;MAGGI ADMINISTRADORA DE CONSÓRCIOS LTDA;Reclamações relacionadas a assuntos diversos;0;0;1;1;
2017;2º;45793395;MASSEY FERGUSON ADMINISTRADORA DE CONSÓRCIOS LTDA;Irregularidades relacionadas à liberação do crédito;0;1;0;1;
2017;2º;45793395;MASSEY FERGUSON ADMINISTRADORA DE CONSÓRCIOS LTDA;Irregularidades relacionadas às condições para contemplação por lance ou sorteio;0;1;0;1;
2017;2º;45793395;MASSEY FERGUSON ADMINISTRADORA DE CONSÓRCIOS LTDA;Reclamações relacionadas a assuntos diversos;0;0;1;1;
2017;2º;46349106;MERCABENCO MERCANTIL E ADMINISTRADORA DE BENS E CONSÓRCIOS LTDA.;Descumprimento de cláusulas referentes à devolução de valores;0;2;0;2;
2017;2º;46349106;MERCABENCO MERCANTIL E ADMINISTRADORA DE BENS E CONSÓRCIOS LTDA.;Descumprimento de obrigações previstas em contratos;0;1;0;1;
2017;2º;46349106;MERCABENCO MERCANTIL E ADMINISTRADORA DE BENS E CONSÓRCIOS LTDA.;Insatisfação com a resposta fornecida pela administradora de consórcio relativa à demanda registrada contra ela;1;0;0;1;
2017;2º;05126027;MOTOASA ADMINISTRADORA DE CONSÓRCIOS LTDA.;Descumprimento de cláusulas referentes à devolução de valores;0;1;0;1;
2017;2º;04124922;MULTIMARCAS ADMINISTRADORA DE CONSORCIOS LTDA.;Ausência de transparência nas relações contratuais;0;0;3;3;
2017;2º;04124922;MULTIMARCAS ADMINISTRADORA DE CONSORCIOS LTDA.;Descumprimento de cláusulas referentes à devolução de valores;0;4;0;4;
2017;2º;04124922;MULTIMARCAS ADMINISTRADORA DE CONSORCIOS LTDA.;Descumprimento de obrigações previstas em contratos;0;1;0;1;
2017;2º;04124922;MULTIMARCAS ADMINISTRADORA DE CONSORCIOS LTDA.;Descumprimento de prazo de resposta a demanda;1;0;0;1;
2017;2º;04124922;MULTIMARCAS ADMINISTRADORA DE CONSORCIOS LTDA.;Insatisfação por parte do cliente com o atendimento prestado pela administradora de consórcio;0;0;2;2;
2017;2º;04124922;MULTIMARCAS ADMINISTRADORA DE CONSORCIOS LTDA.;Irregularidades relacionadas à liberação do crédito;0;1;0;1;
2017;2º;04124922;MULTIMARCAS ADMINISTRADORA DE CONSORCIOS LTDA.;Irregularidades relacionadas às condições para contemplação por lance ou sorteio;0;1;0;1;
2017;2º;04124922;MULTIMARCAS ADMINISTRADORA DE CONSORCIOS LTDA.;Outras irregularidades;0;11;0;11;
2017;2º;04124922;MULTIMARCAS ADMINISTRADORA DE CONSORCIOS LTDA.;Prestação inadequada/insuficiente de informação;0;0;7;7;
2017;2º;04124922;MULTIMARCAS ADMINISTRADORA DE CONSORCIOS LTDA.;Publicidade enganosa;0;0;22;22;
2017;2º;50533876;PAN ADMINISTRADORA DE CONSORCIO LTDA;Ausência de transparência nas relações contratuais;0;0;4;4;
2017;2º;50533876;PAN ADMINISTRADORA DE CONSORCIO LTDA;Cobrança irregular de tarifa pela emissão de boletos, carnês e assemelhados;0;1;0;1;
2017;2º;50533876;PAN ADMINISTRADORA DE CONSORCIO LTDA;Descumprimento de cláusulas referentes à devolução de valores;0;5;0;5;
2017;2º;50533876;PAN ADMINISTRADORA DE CONSORCIO LTDA;Dificuldade na liberação ou substituição de bem;0;0;1;1;
2017;2º;50533876;PAN ADMINISTRADORA DE CONSORCIO LTDA;Insatisfação com a resposta fornecida pela administradora de consórcio relativa à demanda registrada contra ela;0;1;0;1;
2017;2º;50533876;PAN ADMINISTRADORA DE CONSORCIO LTDA;Insatisfação por parte do cliente com o atendimento prestado pela administradora de consórcio;0;0;6;6;
2017;2º;50533876;PAN ADMINISTRADORA DE CONSORCIO LTDA;Irregularidades relacionadas à liberação do crédito;0;3;0;3;
2017;2º;50533876;PAN ADMINISTRADORA DE CONSORCIO LTDA;Irregularidades relacionadas às condições para contemplação por lance ou sorteio;0;3;0;3;
2017;2º;50533876;PAN ADMINISTRADORA DE CONSORCIO LTDA;Prestação inadequada/insuficiente de informação;0;0;3;3;
2017;2º;50533876;PAN ADMINISTRADORA DE CONSORCIO LTDA;Publicidade enganosa;0;0;1;1;
2017;2º;50533876;PAN ADMINISTRADORA DE CONSORCIO LTDA;Reclamações relacionadas a assuntos diversos;0;0;4;4;
2017;2º;50533876;PAN ADMINISTRADORA DE CONSORCIO LTDA;Recusa ou demora no fornecimento de documentos (exceto demonstrativos obrigatórios);0;0;2;2;
2017;2º;16551061;PONTA ADMINISTRADORA DE CONSORCIOS LTDA;Ausência de transparência nas relações contratuais;0;0;1;1;
2017;2º;16551061;PONTA ADMINISTRADORA DE CONSORCIOS LTDA;Descumprimento de cláusulas referentes à devolução de valores;0;1;0;1;
2017;2º;16551061;PONTA ADMINISTRADORA DE CONSORCIOS LTDA;Dificuldade na liberação ou substituição de bem;0;0;2;2;
2017;2º;16551061;PONTA ADMINISTRADORA DE CONSORCIOS LTDA;Insatisfação por parte do cliente com o atendimento prestado pela administradora de consórcio;0;0;3;3;
2017;2º;16551061;PONTA ADMINISTRADORA DE CONSORCIOS LTDA;Irregularidades relacionadas à liberação do crédito;0;4;0;4;
2017;2º;16551061;PONTA ADMINISTRADORA DE CONSORCIOS LTDA;Irregularidades relacionadas às condições para contemplação por lance ou sorteio;0;5;0;5;
2017;2º;16551061;PONTA ADMINISTRADORA DE CONSORCIOS LTDA;Reclamações relacionadas a assuntos diversos;0;0;2;2;
2017;2º;48041735;PORTO SEGURO ADMINISTRADORA DE CONSÓRCIOS LTDA;Ausência de transparência nas relações contratuais;0;0;11;11;
2017;2º;48041735;PORTO SEGURO ADMINISTRADORA DE CONSÓRCIOS LTDA;Descumprimento de cláusulas referentes à devolução de valores;1;2;0;3;
2017;2º;48041735;PORTO SEGURO ADMINISTRADORA DE CONSÓRCIOS LTDA;Descumprimento de obrigações previstas em contratos;0;1;0;1;
2017;2º;48041735;PORTO SEGURO ADMINISTRADORA DE CONSÓRCIOS LTDA;Dificuldade na liberação ou substituição de bem;0;0;3;3;
2017;2º;48041735;PORTO SEGURO ADMINISTRADORA DE CONSÓRCIOS LTDA;Insatisfação com a resposta fornecida pela administradora de consórcio relativa à demanda registrada contra ela;0;2;0;2;
2017;2º;48041735;PORTO SEGURO ADMINISTRADORA DE CONSÓRCIOS LTDA;Insatisfação por parte do cliente com o atendimento prestado pela administradora de consórcio;0;0;8;8;
2017;2º;48041735;PORTO SEGURO ADMINISTRADORA DE CONSÓRCIOS LTDA;Irregularidades relacionadas à liberação do crédito;0;2;0;2;
2017;2º;48041735;PORTO SEGURO ADMINISTRADORA DE CONSÓRCIOS LTDA;Irregularidades relacionadas às condições para contemplação por lance ou sorteio;1;2;0;3;
2017;2º;48041735;PORTO SEGURO ADMINISTRADORA DE CONSÓRCIOS LTDA;Prestação inadequada/insuficiente de informação;0;0;2;2;
2017;2º;48041735;PORTO SEGURO ADMINISTRADORA DE CONSÓRCIOS LTDA;Publicidade enganosa;0;0;1;1;
2017;2º;48041735;PORTO SEGURO ADMINISTRADORA DE CONSÓRCIOS LTDA;Reclamações relacionadas a assuntos diversos;0;0;6;6;
2017;2º;48041735;PORTO SEGURO ADMINISTRADORA DE CONSÓRCIOS LTDA;Recusa ou demora no fornecimento de documentos (exceto demonstrativos obrigatórios);0;0;1;1;
2017;2º;87433413;PORTOBENS ADMINISTRADORA DE CONSORCIOS LTDA;Descumprimento de cláusulas referentes à devolução de valores;0;1;0;1;
2017;2º;87433413;PORTOBENS ADMINISTRADORA DE CONSORCIOS LTDA;Insatisfação por parte do cliente com o atendimento prestado pela administradora de consórcio;0;0;1;1;
2017;2º;87433413;PORTOBENS ADMINISTRADORA DE CONSORCIOS LTDA;Reclamações relacionadas a assuntos diversos;0;0;1;1;
2017;2º;87433413;PORTOBENS ADMINISTRADORA DE CONSORCIOS LTDA;Recusa ou demora no fornecimento de documentos (exceto demonstrativos obrigatórios);0;0;1;1;
2017;2º;51597300;PRIMO ROSSI ADMINISTRADORA DE CONSÓRCIO LTDA.;Descumprimento de cláusulas referentes à devolução de valores;0;9;0;9;
2017;2º;51597300;PRIMO ROSSI ADMINISTRADORA DE CONSÓRCIO LTDA.;Descumprimento de obrigações previstas em contratos;0;11;0;11;
2017;2º;51597300;PRIMO ROSSI ADMINISTRADORA DE CONSÓRCIO LTDA.;Insatisfação com a resposta fornecida pela administradora de consórcio relativa à demanda registrada contra ela;0;1;0;1;
2017;2º;51597300;PRIMO ROSSI ADMINISTRADORA DE CONSÓRCIO LTDA.;Insatisfação por parte do cliente com o atendimento prestado pela administradora de consórcio;0;0;3;3;
2017;2º;51597300;PRIMO ROSSI ADMINISTRADORA DE CONSÓRCIO LTDA.;Irregularidades relacionadas à liberação do crédito;0;1;0;1;
2017;2º;51597300;PRIMO ROSSI ADMINISTRADORA DE CONSÓRCIO LTDA.;Não fornecimento, remessa ou divulgação de documentos obrigatórios;0;1;0;1;
2017;2º;51597300;PRIMO ROSSI ADMINISTRADORA DE CONSÓRCIO LTDA.;Prestação inadequada/insuficiente de informação;0;0;1;1;
2017;2º;51597300;PRIMO ROSSI ADMINISTRADORA DE CONSÓRCIO LTDA.;Reclamações relacionadas a assuntos diversos;0;0;1;1;
2017;2º;51597300;PRIMO ROSSI ADMINISTRADORA DE CONSÓRCIO LTDA.;Recusa ou demora no fornecimento de documentos (exceto demonstrativos obrigatórios);0;0;2;2;
2017;2º;91108027;RANDON ADMINISTRADORA DE CONSÓRCIOS LTDA.;Descumprimento de cláusulas referentes à devolução de valores;0;3;0;3;
2017;2º;91108027;RANDON ADMINISTRADORA DE CONSÓRCIOS LTDA.;Descumprimento de obrigações previstas em contratos;0;1;0;1;
2017;2º;91108027;RANDON ADMINISTRADORA DE CONSÓRCIOS LTDA.;Irregularidades relacionadas à liberação do crédito;0;4;0;4;
2017;2º;66228966;REALIZA ADMINISTRADORA DE CONSÓRCIOS LTDA.;Descumprimento de cláusulas referentes à devolução de valores;0;8;0;8;
2017;2º;66228966;REALIZA ADMINISTRADORA DE CONSÓRCIOS LTDA.;Descumprimento de obrigações previstas em contratos;1;6;0;7;
2017;2º;66228966;REALIZA ADMINISTRADORA DE CONSÓRCIOS LTDA.;Descumprimento de prazo de resposta a demanda;0;2;0;2;
2017;2º;66228966;REALIZA ADMINISTRADORA DE CONSÓRCIOS LTDA.;Insatisfação com a resposta fornecida pela administradora de consórcio relativa à demanda registrada contra ela;0;1;0;1;
2017;2º;66228966;REALIZA ADMINISTRADORA DE CONSÓRCIOS LTDA.;Insatisfação por parte do cliente com o atendimento prestado pela administradora de consórcio;0;0;1;1;
2017;2º;66228966;REALIZA ADMINISTRADORA DE CONSÓRCIOS LTDA.;Irregularidades relacionadas à liberação do crédito;0;1;0;1;
2017;2º;66228966;REALIZA ADMINISTRADORA DE CONSÓRCIOS LTDA.;Outras irregularidades;0;54;0;54;
2017;2º;66228966;REALIZA ADMINISTRADORA DE CONSÓRCIOS LTDA.;Prestação inadequada/insuficiente de informação;0;0;3;3;
2017;2º;66228966;REALIZA ADMINISTRADORA DE CONSÓRCIOS LTDA.;Reclamações relacionadas a assuntos diversos;0;0;3;3;
2017;2º;23767155;RECON ADMINISTRADORA DE CONSORCIOS LTDA;Descumprimento de cláusulas referentes à devolução de valores;0;3;0;3;
2017;2º;23767155;RECON ADMINISTRADORA DE CONSORCIOS LTDA;Insatisfação com a resposta fornecida pela administradora de consórcio relativa à demanda registrada contra ela;0;1;0;1;
2017;2º;23767155;RECON ADMINISTRADORA DE CONSORCIOS LTDA;Irregularidades relacionadas à liberação do crédito;0;1;0;1;
2017;2º;23767155;RECON ADMINISTRADORA DE CONSORCIOS LTDA;Outras irregularidades;1;0;0;1;
2017;2º;23767155;RECON ADMINISTRADORA DE CONSORCIOS LTDA;Prestação inadequada/insuficiente de informação;0;0;6;6;
2017;2º;23767155;RECON ADMINISTRADORA DE CONSORCIOS LTDA;Publicidade enganosa;0;0;1;1;
2017;2º;23767155;RECON ADMINISTRADORA DE CONSORCIOS LTDA;Recusa ou demora no fornecimento de documentos (exceto demonstrativos obrigatórios);0;0;3;3;
2017;2º;62246228;REDENÇÃO ADMINISTRADORA DE CONSÓRCIO LTDA.;Reclamações relacionadas a assuntos diversos;0;0;1;1;
2017;2º;62354055;REMAZA ADMINISTRADORA DE CONSÓRCIO LTDA.;Ausência de transparência nas relações contratuais;0;0;3;3;
2017;2º;62354055;REMAZA ADMINISTRADORA DE CONSÓRCIO LTDA.;Descumprimento de cláusulas referentes à devolução de valores;0;5;0;5;
2017;2º;62354055;REMAZA ADMINISTRADORA DE CONSÓRCIO LTDA.;Descumprimento de obrigações previstas em contratos;0;2;0;2;
2017;2º;62354055;REMAZA ADMINISTRADORA DE CONSÓRCIO LTDA.;Descumprimento de prazo de resposta a demanda;0;2;0;2;
2017;2º;62354055;REMAZA ADMINISTRADORA DE CONSÓRCIO LTDA.;Insatisfação por parte do cliente com o atendimento prestado pela administradora de consórcio;0;0;1;1;
2017;2º;62354055;REMAZA ADMINISTRADORA DE CONSÓRCIO LTDA.;Irregularidades relacionadas à liberação do crédito;0;2;0;2;
2017;2º;62354055;REMAZA ADMINISTRADORA DE CONSÓRCIO LTDA.;Irregularidades relacionadas às condições para contemplação por lance ou sorteio;0;1;0;1;
2017;2º;62354055;REMAZA ADMINISTRADORA DE CONSÓRCIO LTDA.;Outras irregularidades;0;2;0;2;
2017;2º;62354055;REMAZA ADMINISTRADORA DE CONSÓRCIO LTDA.;Prestação inadequada/insuficiente de informação;0;0;5;5;
2017;2º;62354055;REMAZA ADMINISTRADORA DE CONSÓRCIO LTDA.;Publicidade enganosa;0;0;18;18;
2017;2º;62354055;REMAZA ADMINISTRADORA DE CONSÓRCIO LTDA.;Recusa ou demora no fornecimento de documentos (exceto demonstrativos obrigatórios);0;0;1;1;
2017;2º;51855716;RODOBENS ADMINISTRADORA DE CONSÓRCIOS LTDA.;Ausência de transparência nas relações contratuais;0;0;6;6;
2017;2º;51855716;RODOBENS ADMINISTRADORA DE CONSÓRCIOS LTDA.;Descumprimento de cláusulas referentes à devolução de valores;0;19;0;19;
2017;2º;51855716;RODOBENS ADMINISTRADORA DE CONSÓRCIOS LTDA.;Descumprimento de obrigações previstas em contratos;1;6;0;7;
2017;2º;51855716;RODOBENS ADMINISTRADORA DE CONSÓRCIOS LTDA.;Descumprimento de prazo de resposta a demanda;0;1;0;1;
2017;2º;51855716;RODOBENS ADMINISTRADORA DE CONSÓRCIOS LTDA.;Dificuldade na liberação ou substituição de bem;0;0;2;2;
2017;2º;51855716;RODOBENS ADMINISTRADORA DE CONSÓRCIOS LTDA.;Insatisfação com a resposta fornecida pela administradora de consórcio relativa à demanda registrada contra ela;2;5;0;7;
2017;2º;51855716;RODOBENS ADMINISTRADORA DE CONSÓRCIOS LTDA.;Insatisfação por parte do cliente com o atendimento prestado pela administradora de consórcio;0;0;2;2;
2017;2º;51855716;RODOBENS ADMINISTRADORA DE CONSÓRCIOS LTDA.;Irregularidades relacionadas à liberação do crédito;0;8;0;8;
2017;2º;51855716;RODOBENS ADMINISTRADORA DE CONSÓRCIOS LTDA.;Irregularidades relacionadas às condições para contemplação por lance ou sorteio;1;3;0;4;
2017;2º;51855716;RODOBENS ADMINISTRADORA DE CONSÓRCIOS LTDA.;Não fornecimento, remessa ou divulgação de documentos obrigatórios;0;1;0;1;
2017;2º;51855716;RODOBENS ADMINISTRADORA DE CONSÓRCIOS LTDA.;Outras irregularidades;2;1;0;3;
2017;2º;51855716;RODOBENS ADMINISTRADORA DE CONSÓRCIOS LTDA.;Prestação inadequada/insuficiente de informação;0;0;10;10;
2017;2º;51855716;RODOBENS ADMINISTRADORA DE CONSÓRCIOS LTDA.;Reclamações relacionadas a assuntos diversos;0;0;3;3;
2017;2º;51855716;RODOBENS ADMINISTRADORA DE CONSÓRCIOS LTDA.;Recusa ou demora no fornecimento de documentos (exceto demonstrativos obrigatórios);0;0;5;5;
2017;2º;55942312;SANTANDER BRASIL ADMINISTRADORA DE CONSÓRCIO LTDA.;Ausência de transparência nas relações contratuais;0;0;7;7;
2017;2º;55942312;SANTANDER BRASIL ADMINISTRADORA DE CONSÓRCIO LTDA.;Descumprimento de cláusulas referentes à devolução de valores;0;5;0;5;
2017;2º;55942312;SANTANDER BRASIL ADMINISTRADORA DE CONSÓRCIO LTDA.;Descumprimento de obrigações previstas em contratos;1;2;0;3;
2017;2º;55942312;SANTANDER BRASIL ADMINISTRADORA DE CONSÓRCIO LTDA.;Dificuldade na liberação ou substituição de bem;0;0;2;2;
2017;2º;55942312;SANTANDER BRASIL ADMINISTRADORA DE CONSÓRCIO LTDA.;Insatisfação com a resposta fornecida pela administradora de consórcio relativa à demanda registrada contra ela;2;3;0;5;
2017;2º;55942312;SANTANDER BRASIL ADMINISTRADORA DE CONSÓRCIO LTDA.;Insatisfação por parte do cliente com o atendimento prestado pela administradora de consórcio;0;0;16;16;
2017;2º;55942312;SANTANDER BRASIL ADMINISTRADORA DE CONSÓRCIO LTDA.;Irregularidades relacionadas à liberação do crédito;1;22;0;23;
2017;2º;55942312;SANTANDER BRASIL ADMINISTRADORA DE CONSÓRCIO LTDA.;Irregularidades relacionadas às condições para contemplação por lance ou sorteio;0;4;0;4;
2017;2º;55942312;SANTANDER BRASIL ADMINISTRADORA DE CONSÓRCIO LTDA.;Outras irregularidades;1;0;0;1;
2017;2º;55942312;SANTANDER BRASIL ADMINISTRADORA DE CONSÓRCIO LTDA.;Prestação inadequada/insuficiente de informação;0;0;2;2;
2017;2º;55942312;SANTANDER BRASIL ADMINISTRADORA DE CONSÓRCIO LTDA.;Reclamações relacionadas a assuntos diversos;0;0;6;6;
2017;2º;55942312;SANTANDER BRASIL ADMINISTRADORA DE CONSÓRCIO LTDA.;Recusa ou demora no fornecimento de documentos (exceto demonstrativos obrigatórios);0;0;4;4;
2017;2º;76515071;SERVOPA ADMINISTRADORA DE CONSORCIOS LTDA;Descumprimento de cláusulas referentes à devolução de valores;0;3;0;3;
2017;2º;76515071;SERVOPA ADMINISTRADORA DE CONSORCIOS LTDA;Descumprimento de obrigações previstas em contratos;0;2;0;2;
2017;2º;76515071;SERVOPA ADMINISTRADORA DE CONSORCIOS LTDA;Descumprimento de prazo de resposta a demanda;0;1;0;1;
2017;2º;76515071;SERVOPA ADMINISTRADORA DE CONSORCIOS LTDA;Insatisfação com a resposta fornecida pela administradora de consórcio relativa à demanda registrada contra ela;1;0;0;1;
2017;2º;76515071;SERVOPA ADMINISTRADORA DE CONSORCIOS LTDA;Insatisfação por parte do cliente com o atendimento prestado pela administradora de consórcio;0;0;1;1;
2017;2º;76515071;SERVOPA ADMINISTRADORA DE CONSORCIOS LTDA;Outras irregularidades;1;1;0;2;
2017;2º;76515071;SERVOPA ADMINISTRADORA DE CONSORCIOS LTDA;Prestação inadequada/insuficiente de informação;0;0;2;2;
2017;2º;76515071;SERVOPA ADMINISTRADORA DE CONSORCIOS LTDA;Publicidade enganosa;0;0;1;1;
2017;2º;87945218;SIMPALA LANÇADORA E ADMINISTRADORA DE CONSÓRCIOS LTDA.;Descumprimento de cláusulas referentes à devolução de valores;1;1;0;2;
2017;2º;87945218;SIMPALA LANÇADORA E ADMINISTRADORA DE CONSÓRCIOS LTDA.;Reclamações relacionadas a assuntos diversos;0;0;1;1;
2017;2º;87852273;SINOSSERRA ADMINISTRADORA DE CONSÓRCIOS S/A.;Irregularidades relacionadas à liberação do crédito;0;1;0;1;
2017;2º;87852273;SINOSSERRA ADMINISTRADORA DE CONSÓRCIOS S/A.;Prestação inadequada/insuficiente de informação;0;0;3;3;
2017;2º;87636635;SPONCHIADO ADMINISTRADORA DE CONSÓRCIOS LTDA.;Descumprimento de cláusulas referentes à devolução de valores;0;2;0;2;
2017;2º;87636635;SPONCHIADO ADMINISTRADORA DE CONSÓRCIOS LTDA.;Publicidade enganosa;0;0;1;1;
2017;2º;57723801;SUZUKI MOTOS ADMINISTRADORA DE CONSÓRCIO LTDA.;Descumprimento de cláusulas referentes à devolução de valores;1;0;0;1;
2017;2º;57723801;SUZUKI MOTOS ADMINISTRADORA DE CONSÓRCIO LTDA.;Reclamações relacionadas a assuntos diversos;0;0;1;1;
2017;2º;53211488;TARRAF ADMINISTRADORA DE CONSÓRCIOS LTDA.;Descumprimento de cláusulas referentes à devolução de valores;0;2;0;2;
2017;2º;53211488;TARRAF ADMINISTRADORA DE CONSÓRCIOS LTDA.;Irregularidades relacionadas à liberação do crédito;0;1;0;1;
2017;2º;53211488;TARRAF ADMINISTRADORA DE CONSÓRCIOS LTDA.;Outras irregularidades;0;2;0;2;
2017;2º;05551841;TÁGIDE ADMINISTRADORA DE CONSÓRCIOS LTDA.;Descumprimento de cláusulas referentes à devolução de valores;0;1;0;1;
2017;2º;05551841;TÁGIDE ADMINISTRADORA DE CONSÓRCIOS LTDA.;Insatisfação por parte do cliente com o atendimento prestado pela administradora de consórcio;0;0;1;1;
2017;2º;05551841;TÁGIDE ADMINISTRADORA DE CONSÓRCIOS LTDA.;Irregularidades relacionadas à liberação do crédito;0;2;0;2;
2017;2º;59956185;TRADIÇÃO ADMINISTRADORA DE CONSÓRCIO LTDA.;Descumprimento de cláusulas referentes à devolução de valores;0;2;0;2;
2017;2º;59956185;TRADIÇÃO ADMINISTRADORA DE CONSÓRCIO LTDA.;Dificuldade na liberação ou substituição de bem;0;0;1;1;
2017;2º;59956185;TRADIÇÃO ADMINISTRADORA DE CONSÓRCIO LTDA.;Insatisfação por parte do cliente com o atendimento prestado pela administradora de consórcio;0;0;1;1;
2017;2º;59956185;TRADIÇÃO ADMINISTRADORA DE CONSÓRCIO LTDA.;Outras irregularidades;0;1;0;1;
2017;2º;23852429;UNIÃO NACIONAL DOS AUDITORES FISCAIS DA RECEITA FEDERAL - UNAFISCO DE MINAS GERAIS;Prestação inadequada/insuficiente de informação;0;0;1;1;
2017;2º;60732997;UNIFISA ADMINISTRADORA NACIONAL DE CONSORCIOS LTDA;Descumprimento de cláusulas referentes à devolução de valores;0;2;0;2;
2017;2º;60732997;UNIFISA ADMINISTRADORA NACIONAL DE CONSORCIOS LTDA;Descumprimento de obrigações previstas em contratos;1;2;0;3;
2017;2º;60732997;UNIFISA ADMINISTRADORA NACIONAL DE CONSORCIOS LTDA;Insatisfação com a resposta fornecida pela administradora de consórcio relativa à demanda registrada contra ela;0;1;0;1;
2017;2º;60732997;UNIFISA ADMINISTRADORA NACIONAL DE CONSORCIOS LTDA;Outras irregularidades;0;4;0;4;
2017;2º;60732997;UNIFISA ADMINISTRADORA NACIONAL DE CONSORCIOS LTDA;Outras irregularidades relacionadas à Ouvidoria;0;1;0;1;
2017;2º;60732997;UNIFISA ADMINISTRADORA NACIONAL DE CONSORCIOS LTDA;Prestação inadequada/insuficiente de informação;0;0;1;1;
2017;2º;81269516;UNILANCE ADMINISTRADORA DE CONSÓRCIOS LTDA.;Ausência de transparência nas relações contratuais;0;0;6;6;
2017;2º;81269516;UNILANCE ADMINISTRADORA DE CONSÓRCIOS LTDA.;Descumprimento de cláusulas referentes à devolução de valores;0;6;0;6;
2017;2º;81269516;UNILANCE ADMINISTRADORA DE CONSÓRCIOS LTDA.;Descumprimento de obrigações previstas em contratos;0;2;0;2;
2017;2º;81269516;UNILANCE ADMINISTRADORA DE CONSÓRCIOS LTDA.;Descumprimento de prazo de resposta a demanda;0;4;0;4;
2017;2º;81269516;UNILANCE ADMINISTRADORA DE CONSÓRCIOS LTDA.;Insatisfação com a resposta fornecida pela administradora de consórcio relativa à demanda registrada contra ela;0;5;0;5;
2017;2º;81269516;UNILANCE ADMINISTRADORA DE CONSÓRCIOS LTDA.;Irregularidades relacionadas à liberação do crédito;0;1;0;1;
2017;2º;81269516;UNILANCE ADMINISTRADORA DE CONSÓRCIOS LTDA.;Irregularidades relacionadas às condições para contemplação por lance ou sorteio;0;4;0;4;
2017;2º;81269516;UNILANCE ADMINISTRADORA DE CONSÓRCIOS LTDA.;Outras irregularidades;0;10;0;10;
2017;2º;81269516;UNILANCE ADMINISTRADORA DE CONSÓRCIOS LTDA.;Prestação inadequada/insuficiente de informação;0;0;1;1;
2017;2º;81269516;UNILANCE ADMINISTRADORA DE CONSÓRCIOS LTDA.;Recusa ou demora no fornecimento de documentos (exceto demonstrativos obrigatórios);0;0;2;2;
2017;2º;56360266;VALTRA ADMINISTRADORA DE CONSÓRCIOS LTDA;Irregularidades relacionadas à liberação do crédito;0;1;0;1;
2017;2º;74118381;VOLVO ADMINISTRADORA DE CONSÓRCIO LTDA.;Descumprimento de obrigações previstas em contratos;0;2;0;2;
2017;2º;47458153;YAMAHA ADMINISTRADORA DE CONSÓRCIO LTDA.;Descumprimento de cláusulas referentes à devolução de valores;0;3;0;3;
2017;2º;47458153;YAMAHA ADMINISTRADORA DE CONSÓRCIO LTDA.;Descumprimento de obrigações previstas em contratos;0;1;0;1;
2017;2º;47458153;YAMAHA ADMINISTRADORA DE CONSÓRCIO LTDA.;Dificuldade na liberação ou substituição de bem;0;0;1;1;
2017;2º;47458153;YAMAHA ADMINISTRADORA DE CONSÓRCIO LTDA.;Insatisfação por parte do cliente com o atendimento prestado pela administradora de consórcio;0;0;2;2;
2017;2º;47458153;YAMAHA ADMINISTRADORA DE CONSÓRCIO LTDA.;Irregularidades relacionadas à liberação do crédito;0;4;0;4;
2017;2º;47458153;YAMAHA ADMINISTRADORA DE CONSÓRCIO LTDA.;Irregularidades relacionadas às condições para contemplação por lance ou sorteio;0;1;0;1;
2017;2º;47458153;YAMAHA ADMINISTRADORA DE CONSÓRCIO LTDA.;Não fornecimento, remessa ou divulgação de documentos obrigatórios;0;1;0;1;
2017;2º;47458153;YAMAHA ADMINISTRADORA DE CONSÓRCIO LTDA.;Reclamações relacionadas a assuntos diversos;0;0;3;3;
2017;2º;23367634;ZEMA ADMINISTRADORA DE CONSÓRCIO LTDA;Ausência de transparência nas relações contratuais;0;0;1;1;
2017;2º;23367634;ZEMA ADMINISTRADORA DE CONSÓRCIO LTDA;Descumprimento de cláusulas referentes à devolução de valores;0;1;0;1;
2017;2º;23367634;ZEMA ADMINISTRADORA DE CONSÓRCIO LTDA;Descumprimento de obrigações previstas em contratos;0;1;0;1;
2017;2º;23367634;ZEMA ADMINISTRADORA DE CONSÓRCIO LTDA;Golpe;0;0;1;1;
2017;2º;23367634;ZEMA ADMINISTRADORA DE CONSÓRCIO LTDA;Insatisfação com a resposta fornecida pela administradora de consórcio relativa à demanda registrada contra ela;0;3;0;3;
2017;2º;23367634;ZEMA ADMINISTRADORA DE CONSÓRCIO LTDA;Insatisfação por parte do cliente com o atendimento prestado pela administradora de consórcio;0;0;2;2;
2017;2º;23367634;ZEMA ADMINISTRADORA DE CONSÓRCIO LTDA;Irregularidades relacionadas às condições para contemplação por lance ou sorteio;0;2;0;2;
2017;2º;23367634;ZEMA ADMINISTRADORA DE CONSÓRCIO LTDA;Não fornecimento, remessa ou divulgação de documentos obrigatórios;0;5;0;5;
2017;2º;23367634;ZEMA ADMINISTRADORA DE CONSÓRCIO LTDA;Outras irregularidades;1;0;0;1;
2017;2º;23367634;ZEMA ADMINISTRADORA DE CONSÓRCIO LTDA;Prestação inadequada/insuficiente de informação;0;0;3;3;
2017;2º;23367634;ZEMA ADMINISTRADORA DE CONSÓRCIO LTDA;Publicidade enganosa;0;0;8;8;
2017;2º;23367634;ZEMA ADMINISTRADORA DE CONSÓRCIO LTDA;Recusa ou demora no fornecimento de documentos (exceto demonstrativos obrigatórios);0;0;6;6;
