Ano;Semestre;CNPJ AC;Administradora de consórcio;Irregularidade;Quantidade de reclamações reguladas procedentes;Quantidade de reclamações reguladas - outras;Quantidade de reclamações não reguladas;Quantidade total de reclamações;
2023;1º;84911098;ADEMICON ADMINISTRADORA DE CONSÓRCIOS S.A.;Descumprimento de cláusulas referentes à devolução de valores;0;2;0;2;
2023;1º;84911098;ADEMICON ADMINISTRADORA DE CONSÓRCIOS S.A.;Descumprimento de obrigações previstas em contratos;0;1;0;1;
2023;1º;84911098;ADEMICON ADMINISTRADORA DE CONSÓRCIOS S.A.;Falta de transparência na redação de documentos por parte de administradora de consórcio;1;0;0;1;
2023;1º;84911098;ADEMICON ADMINISTRADORA DE CONSÓRCIOS S.A.;Insatisfação com a resposta fornecida pela administradora de consórcio relativa à demanda registrada contra ela;0;1;0;1;
2023;1º;84911098;ADEMICON ADMINISTRADORA DE CONSÓRCIOS S.A.;Irregularidades relacionadas a informações e liquidação de valores a receber no sistema SVR do BCB por parte de consórcios;1;0;0;1;
2023;1º;84911098;ADEMICON ADMINISTRADORA DE CONSÓRCIOS S.A.;Irregularidades relacionadas à liberação do crédito;0;1;0;1;
2023;1º;84911098;ADEMICON ADMINISTRADORA DE CONSÓRCIOS S.A.;Irregularidades relacionadas às condições para contemplação por lance ou sorteio;0;3;0;3;
2023;1º;84911098;ADEMICON ADMINISTRADORA DE CONSÓRCIOS S.A.;Irregularidades relativas a integridade, confiabilidade, segurança, sigilo ou legitimidade das operações e serviços prestados relacionados a administradora de consórcio;4;2;0;6;
2023;1º;84911098;ADEMICON ADMINISTRADORA DE CONSÓRCIOS S.A.;Oferta ou prestação de informação a respeito de produtos e serviços de forma inadequada por administradora de consórcio;1;1;0;2;
2023;1º;84911098;ADEMICON ADMINISTRADORA DE CONSÓRCIOS S.A.;Reclamações relacionadas a assuntos diversos;0;0;1;1;
2023;1º;06044551;ADMINISTRADORA DE CONSORCIO NACIONAL GAZIN LTDA;Irregularidades relacionadas à liberação do crédito;1;0;0;1;
2023;1º;06044551;ADMINISTRADORA DE CONSORCIO NACIONAL GAZIN LTDA;Não fornecimento, remessa ou divulgação de documentos por parte de administradora de consórcio;1;0;0;1;
2023;1º;06044551;ADMINISTRADORA DE CONSORCIO NACIONAL GAZIN LTDA;Oferta ou prestação de informação a respeito de produtos e serviços de forma inadequada por administradora de consórcio;1;0;0;1;
2023;1º;45441789;ADMINISTRADORA DE CONSORCIO NACIONAL HONDA LTDA;Ausência de transparência nas relações contratuais;0;0;6;6;
2023;1º;45441789;ADMINISTRADORA DE CONSORCIO NACIONAL HONDA LTDA;Cancelamento de contrato a pedido do cliente não atendido por administradora de consórcio;0;1;0;1;
2023;1º;45441789;ADMINISTRADORA DE CONSORCIO NACIONAL HONDA LTDA;Cobrança irregular de tarifa pela emissão de boletos, carnês e assemelhados;0;1;0;1;
2023;1º;45441789;ADMINISTRADORA DE CONSORCIO NACIONAL HONDA LTDA;Cobranças Diversas - Consórcio;0;0;1;1;
2023;1º;45441789;ADMINISTRADORA DE CONSORCIO NACIONAL HONDA LTDA;Descumprimento de cláusulas referentes à devolução de valores;3;6;0;9;
2023;1º;45441789;ADMINISTRADORA DE CONSORCIO NACIONAL HONDA LTDA;Descumprimento de obrigações previstas em contratos;0;6;0;6;
2023;1º;45441789;ADMINISTRADORA DE CONSORCIO NACIONAL HONDA LTDA;Descumprimento de prazo de resposta a demanda;0;2;0;2;
2023;1º;45441789;ADMINISTRADORA DE CONSORCIO NACIONAL HONDA LTDA;Insatisfação com a resposta fornecida pela administradora de consórcio relativa à demanda registrada contra ela;4;8;0;12;
2023;1º;45441789;ADMINISTRADORA DE CONSORCIO NACIONAL HONDA LTDA;Insatisfação por parte do cliente com o atendimento prestado pela administradora de consórcio;0;0;2;2;
2023;1º;45441789;ADMINISTRADORA DE CONSORCIO NACIONAL HONDA LTDA;Irregularidades relacionadas a informações e liquidação de valores a receber no sistema SVR do BCB por parte de consórcios;138;21;0;159;
2023;1º;45441789;ADMINISTRADORA DE CONSORCIO NACIONAL HONDA LTDA;Irregularidades relacionadas à liberação do crédito;1;18;0;19;
2023;1º;45441789;ADMINISTRADORA DE CONSORCIO NACIONAL HONDA LTDA;Irregularidades relacionadas às condições para contemplação por lance ou sorteio;0;2;0;2;
2023;1º;45441789;ADMINISTRADORA DE CONSORCIO NACIONAL HONDA LTDA;Irregularidades relativas a integridade, confiabilidade, segurança, sigilo ou legitimidade das operações e serviços prestados relacionados a administradora de consórcio;21;6;0;27;
2023;1º;45441789;ADMINISTRADORA DE CONSORCIO NACIONAL HONDA LTDA;Não fornecimento, remessa ou divulgação de documentos por parte de administradora de consórcio;2;2;0;4;
2023;1º;45441789;ADMINISTRADORA DE CONSORCIO NACIONAL HONDA LTDA;Oferta ou prestação de informação a respeito de produtos e serviços de forma inadequada por administradora de consórcio;4;1;0;5;
2023;1º;45441789;ADMINISTRADORA DE CONSORCIO NACIONAL HONDA LTDA;Reclamações relacionadas a assuntos diversos;0;0;14;14;
2023;1º;07808907;ADMINISTRADORA DE CONSORCIOS SICREDI LTDA;Descumprimento de obrigações previstas em contratos;1;2;0;3;
2023;1º;07808907;ADMINISTRADORA DE CONSORCIOS SICREDI LTDA;Falta de transparência na redação de documentos por parte de administradora de consórcio;1;0;0;1;
2023;1º;07808907;ADMINISTRADORA DE CONSORCIOS SICREDI LTDA;Insatisfação com a resposta fornecida pela administradora de consórcio relativa à demanda registrada contra ela;0;1;0;1;
2023;1º;07808907;ADMINISTRADORA DE CONSORCIOS SICREDI LTDA;Irregularidades relacionadas a informações e liquidação de valores a receber no sistema SVR do BCB por parte de consórcios;3;0;0;3;
2023;1º;07808907;ADMINISTRADORA DE CONSORCIOS SICREDI LTDA;Irregularidades relacionadas à liberação do crédito;0;5;0;5;
2023;1º;07808907;ADMINISTRADORA DE CONSORCIOS SICREDI LTDA;Irregularidades relativas a integridade, confiabilidade, segurança, sigilo ou legitimidade das operações e serviços prestados relacionados a administradora de consórcio;2;1;0;3;
2023;1º;73230674;ADMINISTRADORA DE CONSÓRCIO RCI BRASIL LTDA;Descumprimento de cláusulas referentes à devolução de valores;0;2;0;2;
2023;1º;73230674;ADMINISTRADORA DE CONSÓRCIO RCI BRASIL LTDA;Descumprimento de obrigações previstas em contratos;0;1;0;1;
2023;1º;73230674;ADMINISTRADORA DE CONSÓRCIO RCI BRASIL LTDA;Insatisfação com a resposta fornecida pela administradora de consórcio relativa à demanda registrada contra ela;0;1;0;1;
2023;1º;73230674;ADMINISTRADORA DE CONSÓRCIO RCI BRASIL LTDA;Irregularidades relacionadas à liberação do crédito;0;1;0;1;
2023;1º;73230674;ADMINISTRADORA DE CONSÓRCIO RCI BRASIL LTDA;Irregularidades relacionadas às condições para contemplação por lance ou sorteio;0;1;0;1;
2023;1º;73230674;ADMINISTRADORA DE CONSÓRCIO RCI BRASIL LTDA;Irregularidades relativas a integridade, confiabilidade, segurança, sigilo ou legitimidade das operações e serviços prestados relacionados a administradora de consórcio;3;4;0;7;
2023;1º;73230674;ADMINISTRADORA DE CONSÓRCIO RCI BRASIL LTDA;Oferta ou prestação de informação a respeito de produtos e serviços de forma inadequada por administradora de consórcio;1;0;0;1;
2023;1º;73230674;ADMINISTRADORA DE CONSÓRCIO RCI BRASIL LTDA;Reclamações relacionadas a assuntos diversos;0;0;1;1;
2023;1º;91341925;ADMINISTRADORA DE CONSÓRCIO SPENGLER LTDA.;Descumprimento de prazo de resposta a demanda;0;1;0;1;
2023;1º;91341925;ADMINISTRADORA DE CONSÓRCIO SPENGLER LTDA.;Irregularidades relacionadas a informações e liquidação de valores a receber no sistema SVR do BCB por parte de consórcios;0;1;0;1;
2023;1º;91341925;ADMINISTRADORA DE CONSÓRCIO SPENGLER LTDA.;Não fornecimento, remessa ou divulgação de documentos por parte de administradora de consórcio;1;0;0;1;
2023;1º;12228808;ADMINISTRADORA DE CONSÓRCIO UNICOOB LTDA;Descumprimento de prazo de resposta a demanda;1;0;0;1;
2023;1º;12228808;ADMINISTRADORA DE CONSÓRCIO UNICOOB LTDA;Irregularidades relacionadas a informações e liquidação de valores a receber no sistema SVR do BCB por parte de consórcios;1;0;0;1;
2023;1º;12228808;ADMINISTRADORA DE CONSÓRCIO UNICOOB LTDA;Irregularidades relacionadas às condições para contemplação por lance ou sorteio;1;0;0;1;
2023;1º;03828278;ADMINISTRADORA DE CONSÓRCIOS BECKER LTDA.;Irregularidades relativas a integridade, confiabilidade, segurança, sigilo ou legitimidade das operações e serviços prestados relacionados a administradora de consórcio;1;1;0;2;
2023;1º;94187879;AGIBANK ADMINISTRADORA DE CONSÓRCIOS LTDA;Descumprimento de cláusulas referentes à devolução de valores;2;5;0;7;
2023;1º;94187879;AGIBANK ADMINISTRADORA DE CONSÓRCIOS LTDA;Irregularidades relacionadas a informações e liquidação de valores a receber no sistema SVR do BCB por parte de consórcios;0;1;0;1;
2023;1º;60375243;ANCORA ADMINISTRADORA DE CONSORCIOS S.A.;Descumprimento de obrigações previstas em contratos;0;1;0;1;
2023;1º;60375243;ANCORA ADMINISTRADORA DE CONSORCIOS S.A.;Insatisfação com a resposta fornecida pela administradora de consórcio relativa à demanda registrada contra ela;0;1;0;1;
2023;1º;60375243;ANCORA ADMINISTRADORA DE CONSORCIOS S.A.;Irregularidades relacionadas a informações e liquidação de valores a receber no sistema SVR do BCB por parte de consórcios;0;1;0;1;
2023;1º;60375243;ANCORA ADMINISTRADORA DE CONSORCIOS S.A.;Irregularidades relativas a integridade, confiabilidade, segurança, sigilo ou legitimidade das operações e serviços prestados relacionados a administradora de consórcio;1;3;0;4;
2023;1º;71045363;BAMAQ ADMINISTRADORA DE CONSÓRCIOS LTDA;Cancelamento de contrato a pedido do cliente não atendido por administradora de consórcio;0;1;0;1;
2023;1º;71045363;BAMAQ ADMINISTRADORA DE CONSÓRCIOS LTDA;Descumprimento de cláusulas referentes à devolução de valores;0;1;0;1;
2023;1º;71045363;BAMAQ ADMINISTRADORA DE CONSÓRCIOS LTDA;Insatisfação com a resposta fornecida pela administradora de consórcio relativa à demanda registrada contra ela;0;1;0;1;
2023;1º;71045363;BAMAQ ADMINISTRADORA DE CONSÓRCIOS LTDA;Irregularidades relacionadas a informações e liquidação de valores a receber no sistema SVR do BCB por parte de consórcios;0;2;0;2;
2023;1º;71045363;BAMAQ ADMINISTRADORA DE CONSÓRCIOS LTDA;Irregularidades relativas a integridade, confiabilidade, segurança, sigilo ou legitimidade das operações e serviços prestados relacionados a administradora de consórcio;1;3;0;4;
2023;1º;71045363;BAMAQ ADMINISTRADORA DE CONSÓRCIOS LTDA;Não fornecimento, remessa ou divulgação de documentos por parte de administradora de consórcio;1;1;0;2;
2023;1º;71045363;BAMAQ ADMINISTRADORA DE CONSÓRCIOS LTDA;Oferta ou prestação de informação a respeito de produtos e serviços de forma inadequada por administradora de consórcio;2;0;0;2;
2023;1º;02010478;BANCORBRÁS ADMINISTRADORA DE CONSÓRCIOS S.A.;Descumprimento de obrigações previstas em contratos;0;1;0;1;
2023;1º;02010478;BANCORBRÁS ADMINISTRADORA DE CONSÓRCIOS S.A.;Insatisfação com a resposta fornecida pela administradora de consórcio relativa à demanda registrada contra ela;0;2;0;2;
2023;1º;02010478;BANCORBRÁS ADMINISTRADORA DE CONSÓRCIOS S.A.;Irregularidades relacionadas a informações e liquidação de valores a receber no sistema SVR do BCB por parte de consórcios;1;1;0;2;
2023;1º;02010478;BANCORBRÁS ADMINISTRADORA DE CONSÓRCIOS S.A.;Irregularidades relacionadas à liberação do crédito;0;1;0;1;
2023;1º;02010478;BANCORBRÁS ADMINISTRADORA DE CONSÓRCIOS S.A.;Irregularidades relativas a integridade, confiabilidade, segurança, sigilo ou legitimidade das operações e serviços prestados relacionados a administradora de consórcio;2;1;0;3;
2023;1º;02010478;BANCORBRÁS ADMINISTRADORA DE CONSÓRCIOS S.A.;Outras irregularidades;0;1;0;1;
2023;1º;92692979;BANRISUL S.A. - ADMINISTRADORA DE CONSÓRCIOS;Descumprimento de cláusulas referentes à devolução de valores;0;1;0;1;
2023;1º;92692979;BANRISUL S.A. - ADMINISTRADORA DE CONSÓRCIOS;Descumprimento de obrigações previstas em contratos;0;1;0;1;
2023;1º;92692979;BANRISUL S.A. - ADMINISTRADORA DE CONSÓRCIOS;Insatisfação por parte do cliente com o atendimento prestado pela administradora de consórcio;0;0;1;1;
2023;1º;92692979;BANRISUL S.A. - ADMINISTRADORA DE CONSÓRCIOS;Irregularidades relacionadas a informações e liquidação de valores a receber no sistema SVR do BCB por parte de consórcios;0;1;0;1;
2023;1º;92692979;BANRISUL S.A. - ADMINISTRADORA DE CONSÓRCIOS;Irregularidades relativas a integridade, confiabilidade, segurança, sigilo ou legitimidade das operações e serviços prestados relacionados a administradora de consórcio;1;2;0;3;
2023;1º;92692979;BANRISUL S.A. - ADMINISTRADORA DE CONSÓRCIOS;Oferta ou prestação de informação a respeito de produtos e serviços de forma inadequada por administradora de consórcio;1;0;0;1;
2023;1º;06043050;BB ADMINISTRADORA DE CONSORCIOS S.A.;Ausência de transparência nas relações contratuais;0;0;2;2;
2023;1º;06043050;BB ADMINISTRADORA DE CONSORCIOS S.A.;Cancelamento de contrato a pedido do cliente não atendido por administradora de consórcio;1;1;0;2;
2023;1º;06043050;BB ADMINISTRADORA DE CONSORCIOS S.A.;Cobrança irregular de tarifa pela emissão de boletos, carnês e assemelhados;0;1;0;1;
2023;1º;06043050;BB ADMINISTRADORA DE CONSORCIOS S.A.;Descumprimento de cláusulas referentes à devolução de valores;1;7;0;8;
2023;1º;06043050;BB ADMINISTRADORA DE CONSORCIOS S.A.;Descumprimento de obrigações previstas em contratos;2;7;0;9;
2023;1º;06043050;BB ADMINISTRADORA DE CONSORCIOS S.A.;Insatisfação com a resposta fornecida pela administradora de consórcio relativa à demanda registrada contra ela;3;9;0;12;
2023;1º;06043050;BB ADMINISTRADORA DE CONSORCIOS S.A.;Insatisfação por parte do cliente com o atendimento prestado pela administradora de consórcio;0;0;5;5;
2023;1º;06043050;BB ADMINISTRADORA DE CONSORCIOS S.A.;Irregularidades relacionadas a informações e liquidação de valores a receber no sistema SVR do BCB por parte de consórcios;6;3;0;9;
2023;1º;06043050;BB ADMINISTRADORA DE CONSORCIOS S.A.;Irregularidades relacionadas à liberação do crédito;12;31;0;43;
2023;1º;06043050;BB ADMINISTRADORA DE CONSORCIOS S.A.;Irregularidades relacionadas às condições para contemplação por lance ou sorteio;0;3;0;3;
2023;1º;06043050;BB ADMINISTRADORA DE CONSORCIOS S.A.;Irregularidades relativas a integridade, confiabilidade, segurança, sigilo ou legitimidade das operações e serviços prestados relacionados a administradora de consórcio;74;29;0;103;
2023;1º;06043050;BB ADMINISTRADORA DE CONSORCIOS S.A.;Não fornecimento, remessa ou divulgação de documentos por parte de administradora de consórcio;8;6;0;14;
2023;1º;06043050;BB ADMINISTRADORA DE CONSORCIOS S.A.;Oferta ou prestação de informação a respeito de produtos e serviços de forma inadequada por administradora de consórcio;12;6;0;18;
2023;1º;06043050;BB ADMINISTRADORA DE CONSORCIOS S.A.;Reclamações relacionadas a assuntos diversos;0;0;11;11;
2023;1º;06043050;BB ADMINISTRADORA DE CONSORCIOS S.A.;Recusa de produtos ou serviços - Consórcio;0;0;7;7;
2023;1º;06043050;BB ADMINISTRADORA DE CONSORCIOS S.A.;Renegociação de dívida - Consórcio;0;0;3;3;
2023;1º;06043050;BB ADMINISTRADORA DE CONSORCIOS S.A.;Restrições cadastrais - Consórcio;0;0;1;1;
2023;1º;36770683;BBC ADMINISTRADORA DE CONSÓRCIOS LTDA;Irregularidades relativas a integridade, confiabilidade, segurança, sigilo ou legitimidade das operações e serviços prestados relacionados a administradora de consórcio;0;1;0;1;
2023;1º;36770683;BBC ADMINISTRADORA DE CONSÓRCIOS LTDA;Renegociação de dívida - Consórcio;0;0;1;1;
2023;1º;14723388;BR CONSÓRCIOS ADMINISTRADORA DE CONSÓRCIOS LTDA;Descumprimento de obrigações previstas em contratos;0;1;0;1;
2023;1º;14723388;BR CONSÓRCIOS ADMINISTRADORA DE CONSÓRCIOS LTDA;Irregularidades relacionadas a informações e liquidação de valores a receber no sistema SVR do BCB por parte de consórcios;1;0;0;1;
2023;1º;14723388;BR CONSÓRCIOS ADMINISTRADORA DE CONSÓRCIOS LTDA;Irregularidades relacionadas à liberação do crédito;1;0;0;1;
2023;1º;14723388;BR CONSÓRCIOS ADMINISTRADORA DE CONSÓRCIOS LTDA;Irregularidades relativas a integridade, confiabilidade, segurança, sigilo ou legitimidade das operações e serviços prestados relacionados a administradora de consórcio;1;0;0;1;
2023;1º;14723388;BR CONSÓRCIOS ADMINISTRADORA DE CONSÓRCIOS LTDA;Não fornecimento, remessa ou divulgação de documentos por parte de administradora de consórcio;1;0;0;1;
2023;1º;14723388;BR CONSÓRCIOS ADMINISTRADORA DE CONSÓRCIOS LTDA;Oferta ou prestação de informação a respeito de produtos e serviços de forma inadequada por administradora de consórcio;1;0;0;1;
2023;1º;14723388;BR CONSÓRCIOS ADMINISTRADORA DE CONSÓRCIOS LTDA;Reclamações relacionadas a assuntos diversos;0;0;1;1;
2023;1º;52568821;BRADESCO ADMINISTRADORA DE CONSÓRCIOS LTDA.;Ausência de transparência nas relações contratuais;0;0;6;6;
2023;1º;52568821;BRADESCO ADMINISTRADORA DE CONSÓRCIOS LTDA.;Cancelamento de contrato a pedido do cliente não atendido por administradora de consórcio;2;0;0;2;
2023;1º;52568821;BRADESCO ADMINISTRADORA DE CONSÓRCIOS LTDA.;Cobrança irregular de tarifa pela emissão de boletos, carnês e assemelhados;0;1;0;1;
2023;1º;52568821;BRADESCO ADMINISTRADORA DE CONSÓRCIOS LTDA.;Cobranças Diversas - Consórcio;0;0;2;2;
2023;1º;52568821;BRADESCO ADMINISTRADORA DE CONSÓRCIOS LTDA.;Descumprimento de cláusulas referentes à devolução de valores;16;57;0;73;
2023;1º;52568821;BRADESCO ADMINISTRADORA DE CONSÓRCIOS LTDA.;Descumprimento de obrigações previstas em contratos;6;29;0;35;
2023;1º;52568821;BRADESCO ADMINISTRADORA DE CONSÓRCIOS LTDA.;Descumprimento de ordem judicial - Consórcio;0;0;1;1;
2023;1º;52568821;BRADESCO ADMINISTRADORA DE CONSÓRCIOS LTDA.;Descumprimento de prazo de resposta a demanda;2;3;0;5;
2023;1º;52568821;BRADESCO ADMINISTRADORA DE CONSÓRCIOS LTDA.;Insatisfação com a resposta fornecida pela administradora de consórcio relativa à demanda registrada contra ela;9;43;0;52;
2023;1º;52568821;BRADESCO ADMINISTRADORA DE CONSÓRCIOS LTDA.;Insatisfação por parte do cliente com o atendimento prestado pela administradora de consórcio;0;0;8;8;
2023;1º;52568821;BRADESCO ADMINISTRADORA DE CONSÓRCIOS LTDA.;Irregularidades relacionadas a informações e liquidação de valores a receber no sistema SVR do BCB por parte de consórcios;17;28;0;45;
2023;1º;52568821;BRADESCO ADMINISTRADORA DE CONSÓRCIOS LTDA.;Irregularidades relacionadas à liberação do crédito;17;90;0;107;
2023;1º;52568821;BRADESCO ADMINISTRADORA DE CONSÓRCIOS LTDA.;Irregularidades relacionadas às condições para contemplação por lance ou sorteio;0;5;0;5;
2023;1º;52568821;BRADESCO ADMINISTRADORA DE CONSÓRCIOS LTDA.;Irregularidades relativas a integridade, confiabilidade, segurança, sigilo ou legitimidade das operações e serviços prestados relacionados a administradora de consórcio;172;96;0;268;
2023;1º;52568821;BRADESCO ADMINISTRADORA DE CONSÓRCIOS LTDA.;Irregularidades relativas a telemarketing, SMS ou WhatsApp com oferta de Consórcio;0;0;1;1;
2023;1º;52568821;BRADESCO ADMINISTRADORA DE CONSÓRCIOS LTDA.;Não fornecimento, remessa ou divulgação de documentos por parte de administradora de consórcio;10;10;0;20;
2023;1º;52568821;BRADESCO ADMINISTRADORA DE CONSÓRCIOS LTDA.;Oferta ou prestação de informação a respeito de produtos e serviços de forma inadequada por administradora de consórcio;20;12;0;32;
2023;1º;52568821;BRADESCO ADMINISTRADORA DE CONSÓRCIOS LTDA.;Outras irregularidades;1;1;0;2;
2023;1º;52568821;BRADESCO ADMINISTRADORA DE CONSÓRCIOS LTDA.;Outras irregularidades relacionadas à Ouvidoria;0;1;0;1;
2023;1º;52568821;BRADESCO ADMINISTRADORA DE CONSÓRCIOS LTDA.;Reclamações relacionadas a assuntos diversos;0;0;18;18;
2023;1º;52568821;BRADESCO ADMINISTRADORA DE CONSÓRCIOS LTDA.;Recusa de produtos ou serviços - Consórcio;0;0;9;9;
2023;1º;52568821;BRADESCO ADMINISTRADORA DE CONSÓRCIOS LTDA.;Renegociação de dívida - Consórcio;0;0;1;1;
2023;1º;73235962;BREITKOPF ADMINISTRADORA DE CONSÓRCIO LTDA.;Irregularidades relacionadas a informações e liquidação de valores a receber no sistema SVR do BCB por parte de consórcios;1;0;0;1;
2023;1º;45713971;BRQUALY ADMINISTRADORA DE CONSÓRCIOS LTDA.;Irregularidades relativas a integridade, confiabilidade, segurança, sigilo ou legitimidade das operações e serviços prestados relacionados a administradora de consórcio;1;1;0;2;
2023;1º;68318773;CANOPUS ADMINISTRADORA DE CONSORCIOS S/A;Descumprimento de cláusulas referentes à devolução de valores;0;1;0;1;
2023;1º;68318773;CANOPUS ADMINISTRADORA DE CONSORCIOS S/A;Irregularidades relacionadas à liberação do crédito;0;1;0;1;
2023;1º;68318773;CANOPUS ADMINISTRADORA DE CONSORCIOS S/A;Irregularidades relativas a integridade, confiabilidade, segurança, sigilo ou legitimidade das operações e serviços prestados relacionados a administradora de consórcio;0;2;0;2;
2023;1º;68318773;CANOPUS ADMINISTRADORA DE CONSORCIOS S/A;Oferta ou prestação de informação a respeito de produtos e serviços de forma inadequada por administradora de consórcio;3;1;0;4;
2023;1º;00266031;CICAL ADMINISTRADORA DE CONSÓRCIOS LTDA;Irregularidades relacionadas a informações e liquidação de valores a receber no sistema SVR do BCB por parte de consórcios;2;1;0;3;
2023;1º;59129403;CNF - ADMINISTRADORA DE CONSÓRCIOS NACIONAL LTDA.;Irregularidades relacionadas a informações e liquidação de valores a receber no sistema SVR do BCB por parte de consórcios;2;0;0;2;
2023;1º;59129403;CNF - ADMINISTRADORA DE CONSÓRCIOS NACIONAL LTDA.;Não fornecimento, remessa ou divulgação de documentos por parte de administradora de consórcio;0;1;0;1;
2023;1º;62798475;CNK ADMINISTRADORA DE CONSÓRCIO LTDA.;Cancelamento de contrato a pedido do cliente não atendido por administradora de consórcio;0;1;0;1;
2023;1º;62798475;CNK ADMINISTRADORA DE CONSÓRCIO LTDA.;Descumprimento de obrigações previstas em contratos;0;1;0;1;
2023;1º;62798475;CNK ADMINISTRADORA DE CONSÓRCIO LTDA.;Insatisfação com a resposta fornecida pela administradora de consórcio relativa à demanda registrada contra ela;0;4;0;4;
2023;1º;62798475;CNK ADMINISTRADORA DE CONSÓRCIO LTDA.;Irregularidades relacionadas à liberação do crédito;0;2;0;2;
2023;1º;62798475;CNK ADMINISTRADORA DE CONSÓRCIO LTDA.;Irregularidades relacionadas às condições para contemplação por lance ou sorteio;0;1;0;1;
2023;1º;62798475;CNK ADMINISTRADORA DE CONSÓRCIO LTDA.;Irregularidades relativas a integridade, confiabilidade, segurança, sigilo ou legitimidade das operações e serviços prestados relacionados a administradora de consórcio;0;2;0;2;
2023;1º;62798475;CNK ADMINISTRADORA DE CONSÓRCIO LTDA.;Oferta ou prestação de informação a respeito de produtos e serviços de forma inadequada por administradora de consórcio;7;9;0;16;
2023;1º;62798475;CNK ADMINISTRADORA DE CONSÓRCIO LTDA.;Reclamações relacionadas a assuntos diversos;0;0;1;1;
2023;1º;05349595;CNP CONSÓRCIO S.A. ADMINISTRADORA DE CONSÓRCIOS;Ausência de transparência nas relações contratuais;0;0;3;3;
2023;1º;05349595;CNP CONSÓRCIO S.A. ADMINISTRADORA DE CONSÓRCIOS;Cancelamento de contrato a pedido do cliente não atendido por administradora de consórcio;0;2;0;2;
2023;1º;05349595;CNP CONSÓRCIO S.A. ADMINISTRADORA DE CONSÓRCIOS;Cobranças Diversas - Consórcio;0;0;2;2;
2023;1º;05349595;CNP CONSÓRCIO S.A. ADMINISTRADORA DE CONSÓRCIOS;Descumprimento de cláusulas referentes à devolução de valores;8;16;0;24;
2023;1º;05349595;CNP CONSÓRCIO S.A. ADMINISTRADORA DE CONSÓRCIOS;Descumprimento de obrigações previstas em contratos;2;6;0;8;
2023;1º;05349595;CNP CONSÓRCIO S.A. ADMINISTRADORA DE CONSÓRCIOS;Falta de transparência na redação de documentos por parte de administradora de consórcio;1;0;0;1;
2023;1º;05349595;CNP CONSÓRCIO S.A. ADMINISTRADORA DE CONSÓRCIOS;Insatisfação com a resposta fornecida pela administradora de consórcio relativa à demanda registrada contra ela;1;8;0;9;
2023;1º;05349595;CNP CONSÓRCIO S.A. ADMINISTRADORA DE CONSÓRCIOS;Insatisfação por parte do cliente com o atendimento prestado pela administradora de consórcio;0;0;3;3;
2023;1º;05349595;CNP CONSÓRCIO S.A. ADMINISTRADORA DE CONSÓRCIOS;Irregularidades relacionadas a informações e liquidação de valores a receber no sistema SVR do BCB por parte de consórcios;14;21;0;35;
2023;1º;05349595;CNP CONSÓRCIO S.A. ADMINISTRADORA DE CONSÓRCIOS;Irregularidades relacionadas à liberação do crédito;4;18;0;22;
2023;1º;05349595;CNP CONSÓRCIO S.A. ADMINISTRADORA DE CONSÓRCIOS;Irregularidades relacionadas às condições para contemplação por lance ou sorteio;0;4;0;4;
2023;1º;05349595;CNP CONSÓRCIO S.A. ADMINISTRADORA DE CONSÓRCIOS;Irregularidades relativas a integridade, confiabilidade, segurança, sigilo ou legitimidade das operações e serviços prestados relacionados a administradora de consórcio;36;26;0;62;
2023;1º;05349595;CNP CONSÓRCIO S.A. ADMINISTRADORA DE CONSÓRCIOS;Não fornecimento, remessa ou divulgação de documentos por parte de administradora de consórcio;3;2;0;5;
2023;1º;05349595;CNP CONSÓRCIO S.A. ADMINISTRADORA DE CONSÓRCIOS;Oferta ou prestação de informação a respeito de produtos e serviços de forma inadequada por administradora de consórcio;24;2;0;26;
2023;1º;05349595;CNP CONSÓRCIO S.A. ADMINISTRADORA DE CONSÓRCIOS;Reclamações relacionadas a assuntos diversos;0;0;4;4;
2023;1º;05349595;CNP CONSÓRCIO S.A. ADMINISTRADORA DE CONSÓRCIOS;Recusa de produtos ou serviços - Consórcio;0;0;1;1;
2023;1º;27268770;COIMEX ADMINISTRADORA DE CONSÓRCIOS S.A.;Descumprimento de cláusulas referentes à devolução de valores;0;1;0;1;
2023;1º;27268770;COIMEX ADMINISTRADORA DE CONSÓRCIOS S.A.;Insatisfação com a resposta fornecida pela administradora de consórcio relativa à demanda registrada contra ela;1;0;0;1;
2023;1º;27268770;COIMEX ADMINISTRADORA DE CONSÓRCIOS S.A.;Irregularidades relacionadas a informações e liquidação de valores a receber no sistema SVR do BCB por parte de consórcios;1;0;0;1;
2023;1º;27268770;COIMEX ADMINISTRADORA DE CONSÓRCIOS S.A.;Irregularidades relacionadas às condições para contemplação por lance ou sorteio;1;3;0;4;
2023;1º;27268770;COIMEX ADMINISTRADORA DE CONSÓRCIOS S.A.;Irregularidades relativas a integridade, confiabilidade, segurança, sigilo ou legitimidade das operações e serviços prestados relacionados a administradora de consórcio;1;2;0;3;
2023;1º;27268770;COIMEX ADMINISTRADORA DE CONSÓRCIOS S.A.;Não fornecimento, remessa ou divulgação de documentos por parte de administradora de consórcio;2;1;0;3;
2023;1º;27268770;COIMEX ADMINISTRADORA DE CONSÓRCIOS S.A.;Oferta ou prestação de informação a respeito de produtos e serviços de forma inadequada por administradora de consórcio;1;1;0;2;
2023;1º;27268770;COIMEX ADMINISTRADORA DE CONSÓRCIOS S.A.;Reclamações relacionadas a assuntos diversos;0;0;1;1;
2023;1º;27268770;COIMEX ADMINISTRADORA DE CONSÓRCIOS S.A.;Renegociação de dívida - Consórcio;0;0;2;2;
2023;1º;44196293;CONSHOP ADMINISTRADORA DE CONSORCIOS LTDA.;Irregularidades relacionadas a informações e liquidação de valores a receber no sistema SVR do BCB por parte de consórcios;1;0;0;1;
2023;1º;44196293;CONSHOP ADMINISTRADORA DE CONSORCIOS LTDA.;Irregularidades relativas a integridade, confiabilidade, segurança, sigilo ou legitimidade das operações e serviços prestados relacionados a administradora de consórcio;1;0;0;1;
2023;1º;44196293;CONSHOP ADMINISTRADORA DE CONSORCIOS LTDA.;Oferta ou prestação de informação a respeito de produtos e serviços de forma inadequada por administradora de consórcio;1;1;0;2;
2023;1º;47658539;CONSÓRCIO NACIONAL VOLKSWAGEN - ADMINISTRADORA DE CONSÓRCIO LTDA.;Ausência de transparência nas relações contratuais;0;0;1;1;
2023;1º;47658539;CONSÓRCIO NACIONAL VOLKSWAGEN - ADMINISTRADORA DE CONSÓRCIO LTDA.;Descumprimento de cláusulas referentes à devolução de valores;8;12;0;20;
2023;1º;47658539;CONSÓRCIO NACIONAL VOLKSWAGEN - ADMINISTRADORA DE CONSÓRCIO LTDA.;Descumprimento de obrigações previstas em contratos;0;9;0;9;
2023;1º;47658539;CONSÓRCIO NACIONAL VOLKSWAGEN - ADMINISTRADORA DE CONSÓRCIO LTDA.;Insatisfação com a resposta fornecida pela administradora de consórcio relativa à demanda registrada contra ela;5;10;0;15;
2023;1º;47658539;CONSÓRCIO NACIONAL VOLKSWAGEN - ADMINISTRADORA DE CONSÓRCIO LTDA.;Insatisfação por parte do cliente com o atendimento prestado pela administradora de consórcio;0;0;4;4;
2023;1º;47658539;CONSÓRCIO NACIONAL VOLKSWAGEN - ADMINISTRADORA DE CONSÓRCIO LTDA.;Irregularidades relacionadas a informações e liquidação de valores a receber no sistema SVR do BCB por parte de consórcios;26;11;0;37;
2023;1º;47658539;CONSÓRCIO NACIONAL VOLKSWAGEN - ADMINISTRADORA DE CONSÓRCIO LTDA.;Irregularidades relacionadas à liberação do crédito;9;12;0;21;
2023;1º;47658539;CONSÓRCIO NACIONAL VOLKSWAGEN - ADMINISTRADORA DE CONSÓRCIO LTDA.;Irregularidades relacionadas às condições para contemplação por lance ou sorteio;0;2;0;2;
2023;1º;47658539;CONSÓRCIO NACIONAL VOLKSWAGEN - ADMINISTRADORA DE CONSÓRCIO LTDA.;Irregularidades relativas a integridade, confiabilidade, segurança, sigilo ou legitimidade das operações e serviços prestados relacionados a administradora de consórcio;36;12;0;48;
2023;1º;47658539;CONSÓRCIO NACIONAL VOLKSWAGEN - ADMINISTRADORA DE CONSÓRCIO LTDA.;Não fornecimento, remessa ou divulgação de documentos por parte de administradora de consórcio;5;1;0;6;
2023;1º;47658539;CONSÓRCIO NACIONAL VOLKSWAGEN - ADMINISTRADORA DE CONSÓRCIO LTDA.;Oferta ou prestação de informação a respeito de produtos e serviços de forma inadequada por administradora de consórcio;3;2;0;5;
2023;1º;47658539;CONSÓRCIO NACIONAL VOLKSWAGEN - ADMINISTRADORA DE CONSÓRCIO LTDA.;Reclamações relacionadas a assuntos diversos;0;0;2;2;
2023;1º;47658539;CONSÓRCIO NACIONAL VOLKSWAGEN - ADMINISTRADORA DE CONSÓRCIO LTDA.;Recusa de produtos ou serviços - Consórcio;0;0;1;1;
2023;1º;58919903;CONVEF ADMINISTRADORA DE CONSÓRCIOS LTDA.;Descumprimento de cláusulas referentes à devolução de valores;0;3;0;3;
2023;1º;58919903;CONVEF ADMINISTRADORA DE CONSÓRCIOS LTDA.;Descumprimento de obrigações previstas em contratos;1;1;0;2;
2023;1º;58919903;CONVEF ADMINISTRADORA DE CONSÓRCIOS LTDA.;Insatisfação por parte do cliente com o atendimento prestado pela administradora de consórcio;0;0;1;1;
2023;1º;58919903;CONVEF ADMINISTRADORA DE CONSÓRCIOS LTDA.;Irregularidades relacionadas a informações e liquidação de valores a receber no sistema SVR do BCB por parte de consórcios;2;2;0;4;
2023;1º;58919903;CONVEF ADMINISTRADORA DE CONSÓRCIOS LTDA.;Não fornecimento, remessa ou divulgação de documentos por parte de administradora de consórcio;1;0;0;1;
2023;1º;58919903;CONVEF ADMINISTRADORA DE CONSÓRCIOS LTDA.;Reclamações relacionadas a assuntos diversos;0;0;1;1;
2023;1º;61550836;COOPERATIVA MISTA ROMA;Descumprimento de cláusulas referentes à devolução de valores;0;6;0;6;
2023;1º;61550836;COOPERATIVA MISTA ROMA;Insatisfação com a resposta fornecida pela administradora de consórcio relativa à demanda registrada contra ela;1;3;0;4;
2023;1º;61550836;COOPERATIVA MISTA ROMA;Insatisfação por parte do cliente com o atendimento prestado pela administradora de consórcio;0;0;1;1;
2023;1º;61550836;COOPERATIVA MISTA ROMA;Irregularidades relacionadas à liberação do crédito;0;1;0;1;
2023;1º;61550836;COOPERATIVA MISTA ROMA;Irregularidades relacionadas às condições para contemplação por lance ou sorteio;0;1;0;1;
2023;1º;61550836;COOPERATIVA MISTA ROMA;Irregularidades relativas a integridade, confiabilidade, segurança, sigilo ou legitimidade das operações e serviços prestados relacionados a administradora de consórcio;3;2;0;5;
2023;1º;61550836;COOPERATIVA MISTA ROMA;Não fornecimento, remessa ou divulgação de documentos por parte de administradora de consórcio;0;1;0;1;
2023;1º;61550836;COOPERATIVA MISTA ROMA;Oferta ou prestação de informação a respeito de produtos e serviços de forma inadequada por administradora de consórcio;21;9;0;30;
2023;1º;61550836;COOPERATIVA MISTA ROMA;Reclamações relacionadas a assuntos diversos;0;0;2;2;
2023;1º;05794450;DESTAQUE ADMINISTRADORA DE CONSORCIOS LTDA;Irregularidades relacionadas a informações e liquidação de valores a receber no sistema SVR do BCB por parte de consórcios;2;0;0;2;
2023;1º;59395061;DISAL ADMINISTRADORA DE CONSÓRCIOS LTDA;Cancelamento de contrato a pedido do cliente não atendido por administradora de consórcio;1;2;0;3;
2023;1º;59395061;DISAL ADMINISTRADORA DE CONSÓRCIOS LTDA;Descumprimento de cláusulas referentes à devolução de valores;6;10;0;16;
2023;1º;59395061;DISAL ADMINISTRADORA DE CONSÓRCIOS LTDA;Descumprimento de obrigações previstas em contratos;0;9;0;9;
2023;1º;59395061;DISAL ADMINISTRADORA DE CONSÓRCIOS LTDA;Descumprimento de prazo de resposta a demanda;0;2;0;2;
2023;1º;59395061;DISAL ADMINISTRADORA DE CONSÓRCIOS LTDA;Insatisfação com a resposta fornecida pela administradora de consórcio relativa à demanda registrada contra ela;4;3;0;7;
2023;1º;59395061;DISAL ADMINISTRADORA DE CONSÓRCIOS LTDA;Irregularidades relacionadas a informações e liquidação de valores a receber no sistema SVR do BCB por parte de consórcios;19;11;0;30;
2023;1º;59395061;DISAL ADMINISTRADORA DE CONSÓRCIOS LTDA;Irregularidades relacionadas à liberação do crédito;10;21;0;31;
2023;1º;59395061;DISAL ADMINISTRADORA DE CONSÓRCIOS LTDA;Irregularidades relacionadas às condições para contemplação por lance ou sorteio;0;2;0;2;
2023;1º;59395061;DISAL ADMINISTRADORA DE CONSÓRCIOS LTDA;Irregularidades relativas a integridade, confiabilidade, segurança, sigilo ou legitimidade das operações e serviços prestados relacionados a administradora de consórcio;26;16;0;42;
2023;1º;59395061;DISAL ADMINISTRADORA DE CONSÓRCIOS LTDA;Não fornecimento, remessa ou divulgação de documentos por parte de administradora de consórcio;2;1;0;3;
2023;1º;59395061;DISAL ADMINISTRADORA DE CONSÓRCIOS LTDA;Oferta ou prestação de informação a respeito de produtos e serviços de forma inadequada por administradora de consórcio;10;2;0;12;
2023;1º;59395061;DISAL ADMINISTRADORA DE CONSÓRCIOS LTDA;Reclamações relacionadas a assuntos diversos;0;0;3;3;
2023;1º;01659838;DISBRAVE ADMINISTRADORA DE CONSORCIOS LTDA.;Descumprimento de cláusulas referentes à devolução de valores;0;4;0;4;
2023;1º;01659838;DISBRAVE ADMINISTRADORA DE CONSORCIOS LTDA.;Descumprimento de prazo de resposta a demanda;0;1;0;1;
2023;1º;01659838;DISBRAVE ADMINISTRADORA DE CONSORCIOS LTDA.;Insatisfação com a resposta fornecida pela administradora de consórcio relativa à demanda registrada contra ela;0;3;0;3;
2023;1º;01659838;DISBRAVE ADMINISTRADORA DE CONSORCIOS LTDA.;Insatisfação por parte do cliente com o atendimento prestado pela administradora de consórcio;0;0;2;2;
2023;1º;01659838;DISBRAVE ADMINISTRADORA DE CONSORCIOS LTDA.;Irregularidades relacionadas a informações e liquidação de valores a receber no sistema SVR do BCB por parte de consórcios;3;0;0;3;
2023;1º;01659838;DISBRAVE ADMINISTRADORA DE CONSORCIOS LTDA.;Irregularidades relativas a integridade, confiabilidade, segurança, sigilo ou legitimidade das operações e serviços prestados relacionados a administradora de consórcio;5;5;0;10;
2023;1º;01659838;DISBRAVE ADMINISTRADORA DE CONSORCIOS LTDA.;Oferta ou prestação de informação a respeito de produtos e serviços de forma inadequada por administradora de consórcio;1;1;0;2;
2023;1º;08570707;ELDORADO ADMINISTRADORA DE CONSORCIO LTDA;Irregularidades relativas a integridade, confiabilidade, segurança, sigilo ou legitimidade das operações e serviços prestados relacionados a administradora de consórcio;0;1;0;1;
2023;1º;58113812;EMBRACON ADMINISTRADORA DE CONSÓRCIO LTDA;Ausência de transparência nas relações contratuais;0;0;1;1;
2023;1º;58113812;EMBRACON ADMINISTRADORA DE CONSÓRCIO LTDA;Cancelamento de contrato a pedido do cliente não atendido por administradora de consórcio;2;1;0;3;
2023;1º;58113812;EMBRACON ADMINISTRADORA DE CONSÓRCIO LTDA;Descumprimento de cláusulas referentes à devolução de valores;6;23;0;29;
2023;1º;58113812;EMBRACON ADMINISTRADORA DE CONSÓRCIO LTDA;Descumprimento de obrigações previstas em contratos;2;4;0;6;
2023;1º;58113812;EMBRACON ADMINISTRADORA DE CONSÓRCIO LTDA;Falta de transparência na redação de documentos por parte de administradora de consórcio;1;0;0;1;
2023;1º;58113812;EMBRACON ADMINISTRADORA DE CONSÓRCIO LTDA;Insatisfação com a resposta fornecida pela administradora de consórcio relativa à demanda registrada contra ela;0;9;0;9;
2023;1º;58113812;EMBRACON ADMINISTRADORA DE CONSÓRCIO LTDA;Insatisfação por parte do cliente com o atendimento prestado pela administradora de consórcio;0;0;6;6;
2023;1º;58113812;EMBRACON ADMINISTRADORA DE CONSÓRCIO LTDA;Irregularidades relacionadas a informações e liquidação de valores a receber no sistema SVR do BCB por parte de consórcios;4;13;0;17;
2023;1º;58113812;EMBRACON ADMINISTRADORA DE CONSÓRCIO LTDA;Irregularidades relacionadas à liberação do crédito;3;14;0;17;
2023;1º;58113812;EMBRACON ADMINISTRADORA DE CONSÓRCIO LTDA;Irregularidades relacionadas às condições para contemplação por lance ou sorteio;0;2;0;2;
2023;1º;58113812;EMBRACON ADMINISTRADORA DE CONSÓRCIO LTDA;Irregularidades relativas a integridade, confiabilidade, segurança, sigilo ou legitimidade das operações e serviços prestados relacionados a administradora de consórcio;18;30;0;48;
2023;1º;58113812;EMBRACON ADMINISTRADORA DE CONSÓRCIO LTDA;Não fornecimento, remessa ou divulgação de documentos por parte de administradora de consórcio;1;3;0;4;
2023;1º;58113812;EMBRACON ADMINISTRADORA DE CONSÓRCIO LTDA;Oferta ou prestação de informação a respeito de produtos e serviços de forma inadequada por administradora de consórcio;24;14;0;38;
2023;1º;58113812;EMBRACON ADMINISTRADORA DE CONSÓRCIO LTDA;Outras irregularidades;1;0;0;1;
2023;1º;58113812;EMBRACON ADMINISTRADORA DE CONSÓRCIO LTDA;Outras irregularidades relacionadas à Ouvidoria;1;0;0;1;
2023;1º;58113812;EMBRACON ADMINISTRADORA DE CONSÓRCIO LTDA;Reclamações relacionadas a assuntos diversos;0;0;6;6;
2023;1º;58113812;EMBRACON ADMINISTRADORA DE CONSÓRCIO LTDA;Recusa de produtos ou serviços - Consórcio;0;0;1;1;
2023;1º;58113812;EMBRACON ADMINISTRADORA DE CONSÓRCIO LTDA;Renegociação de dívida - Consórcio;0;0;2;2;
2023;1º;42735881;EVOY ADMINISTRADORA DE CONSORCIO LTDA.;Oferta ou prestação de informação a respeito de produtos e serviços de forma inadequada por administradora de consórcio;2;0;0;2;
2023;1º;91107581;FARROUPILHA ADMINISTRADORA DE CONSÓRCIOS LTDA.;Insatisfação por parte do cliente com o atendimento prestado pela administradora de consórcio;0;0;1;1;
2023;1º;91107581;FARROUPILHA ADMINISTRADORA DE CONSÓRCIOS LTDA.;Irregularidades relacionadas a informações e liquidação de valores a receber no sistema SVR do BCB por parte de consórcios;0;1;0;1;
2023;1º;91107581;FARROUPILHA ADMINISTRADORA DE CONSÓRCIOS LTDA.;Recusa de produtos ou serviços - Consórcio;0;0;1;1;
2023;1º;00643742;FUNDACAO HABITACIONAL DO EXERCITO - FHE;Recusa de produtos ou serviços - Consórcio;0;0;1;1;
2023;1º;85322204;GLOBO ADMINISTRADORA DE CONSÓRCIOS LTDA.;Irregularidades relacionadas a informações e liquidação de valores a receber no sistema SVR do BCB por parte de consórcios;0;1;0;1;
2023;1º;85322204;GLOBO ADMINISTRADORA DE CONSÓRCIOS LTDA.;Irregularidades relativas a integridade, confiabilidade, segurança, sigilo ou legitimidade das operações e serviços prestados relacionados a administradora de consórcio;0;1;0;1;
2023;1º;49937055;GMAC ADMINISTRADORA DE CONSORCIOS LTDA;Ausência de transparência nas relações contratuais;0;0;2;2;
2023;1º;49937055;GMAC ADMINISTRADORA DE CONSORCIOS LTDA;Cancelamento de contrato a pedido do cliente não atendido por administradora de consórcio;1;1;0;2;
2023;1º;49937055;GMAC ADMINISTRADORA DE CONSORCIOS LTDA;Descumprimento de cláusulas referentes à devolução de valores;0;7;0;7;
2023;1º;49937055;GMAC ADMINISTRADORA DE CONSORCIOS LTDA;Descumprimento de obrigações previstas em contratos;0;5;0;5;
2023;1º;49937055;GMAC ADMINISTRADORA DE CONSORCIOS LTDA;Descumprimento de prazo de resposta a demanda;0;1;0;1;
2023;1º;49937055;GMAC ADMINISTRADORA DE CONSORCIOS LTDA;Insatisfação com a resposta fornecida pela administradora de consórcio relativa à demanda registrada contra ela;2;2;0;4;
2023;1º;49937055;GMAC ADMINISTRADORA DE CONSORCIOS LTDA;Insatisfação por parte do cliente com o atendimento prestado pela administradora de consórcio;0;0;2;2;
2023;1º;49937055;GMAC ADMINISTRADORA DE CONSORCIOS LTDA;Irregularidades relacionadas a informações e liquidação de valores a receber no sistema SVR do BCB por parte de consórcios;20;14;0;34;
2023;1º;49937055;GMAC ADMINISTRADORA DE CONSORCIOS LTDA;Irregularidades relacionadas à liberação do crédito;2;10;0;12;
2023;1º;49937055;GMAC ADMINISTRADORA DE CONSORCIOS LTDA;Irregularidades relacionadas às condições para contemplação por lance ou sorteio;0;1;0;1;
2023;1º;49937055;GMAC ADMINISTRADORA DE CONSORCIOS LTDA;Irregularidades relativas a integridade, confiabilidade, segurança, sigilo ou legitimidade das operações e serviços prestados relacionados a administradora de consórcio;12;9;0;21;
2023;1º;49937055;GMAC ADMINISTRADORA DE CONSORCIOS LTDA;Não fornecimento, remessa ou divulgação de documentos por parte de administradora de consórcio;1;3;0;4;
2023;1º;49937055;GMAC ADMINISTRADORA DE CONSORCIOS LTDA;Oferta ou prestação de informação a respeito de produtos e serviços de forma inadequada por administradora de consórcio;8;1;0;9;
2023;1º;49937055;GMAC ADMINISTRADORA DE CONSORCIOS LTDA;Reclamações relacionadas a assuntos diversos;0;0;1;1;
2023;1º;49937055;GMAC ADMINISTRADORA DE CONSORCIOS LTDA;Renegociação de dívida - Consórcio;0;0;1;1;
2023;1º;91338228;GRAVEL ADMINISTRADORA DE CONSÓRCIOS LTDA.;Irregularidades relacionadas a informações e liquidação de valores a receber no sistema SVR do BCB por parte de consórcios;2;0;0;2;
2023;1º;26228270;GROSCON ADMINISTRADORA DE CONSORCIOS LTDA.;Insatisfação com a resposta fornecida pela administradora de consórcio relativa à demanda registrada contra ela;1;0;0;1;
2023;1º;26228270;GROSCON ADMINISTRADORA DE CONSORCIOS LTDA.;Não fornecimento, remessa ou divulgação de documentos por parte de administradora de consórcio;1;0;0;1;
2023;1º;26228270;GROSCON ADMINISTRADORA DE CONSORCIOS LTDA.;Oferta ou prestação de informação a respeito de produtos e serviços de forma inadequada por administradora de consórcio;1;0;0;1;
2023;1º;73516106;HS ADMINISTRADORA DE CONSÓRCIOS LTDA;Descumprimento de cláusulas referentes à devolução de valores;0;3;0;3;
2023;1º;73516106;HS ADMINISTRADORA DE CONSÓRCIOS LTDA;Descumprimento de obrigações previstas em contratos;0;1;0;1;
2023;1º;73516106;HS ADMINISTRADORA DE CONSÓRCIOS LTDA;Insatisfação com a resposta fornecida pela administradora de consórcio relativa à demanda registrada contra ela;1;1;0;2;
2023;1º;73516106;HS ADMINISTRADORA DE CONSÓRCIOS LTDA;Insatisfação por parte do cliente com o atendimento prestado pela administradora de consórcio;0;0;1;1;
2023;1º;73516106;HS ADMINISTRADORA DE CONSÓRCIOS LTDA;Irregularidades relacionadas a informações e liquidação de valores a receber no sistema SVR do BCB por parte de consórcios;2;3;0;5;
2023;1º;73516106;HS ADMINISTRADORA DE CONSÓRCIOS LTDA;Irregularidades relacionadas à liberação do crédito;1;9;0;10;
2023;1º;73516106;HS ADMINISTRADORA DE CONSÓRCIOS LTDA;Irregularidades relacionadas às condições para contemplação por lance ou sorteio;0;1;0;1;
2023;1º;73516106;HS ADMINISTRADORA DE CONSÓRCIOS LTDA;Irregularidades relativas a integridade, confiabilidade, segurança, sigilo ou legitimidade das operações e serviços prestados relacionados a administradora de consórcio;7;8;0;15;
2023;1º;73516106;HS ADMINISTRADORA DE CONSÓRCIOS LTDA;Oferta ou prestação de informação a respeito de produtos e serviços de forma inadequada por administradora de consórcio;3;1;0;4;
2023;1º;73516106;HS ADMINISTRADORA DE CONSÓRCIOS LTDA;Reclamações relacionadas a assuntos diversos;0;0;2;2;
2023;1º;73516106;HS ADMINISTRADORA DE CONSÓRCIOS LTDA;Renegociação de dívida - Consórcio;0;0;1;1;
2023;1º;00000776;ITAÚ ADMINISTRADORA DE CONSÓRCIOS LTDA.;Cancelamento de contrato a pedido do cliente não atendido por administradora de consórcio;3;1;0;4;
2023;1º;00000776;ITAÚ ADMINISTRADORA DE CONSÓRCIOS LTDA.;Cobrança irregular de tarifa pela emissão de boletos, carnês e assemelhados;0;2;0;2;
2023;1º;00000776;ITAÚ ADMINISTRADORA DE CONSÓRCIOS LTDA.;Cobranças Diversas - Consórcio;0;0;1;1;
2023;1º;00000776;ITAÚ ADMINISTRADORA DE CONSÓRCIOS LTDA.;Descumprimento de cláusulas referentes à devolução de valores;2;21;0;23;
2023;1º;00000776;ITAÚ ADMINISTRADORA DE CONSÓRCIOS LTDA.;Descumprimento de obrigações previstas em contratos;3;8;0;11;
2023;1º;00000776;ITAÚ ADMINISTRADORA DE CONSÓRCIOS LTDA.;Insatisfação com a resposta fornecida pela administradora de consórcio relativa à demanda registrada contra ela;3;9;0;12;
2023;1º;00000776;ITAÚ ADMINISTRADORA DE CONSÓRCIOS LTDA.;Insatisfação por parte do cliente com o atendimento prestado pela administradora de consórcio;0;0;2;2;
2023;1º;00000776;ITAÚ ADMINISTRADORA DE CONSÓRCIOS LTDA.;Irregularidades relacionadas a informações e liquidação de valores a receber no sistema SVR do BCB por parte de consórcios;15;4;0;19;
2023;1º;00000776;ITAÚ ADMINISTRADORA DE CONSÓRCIOS LTDA.;Irregularidades relacionadas à liberação do crédito;3;22;0;25;
2023;1º;00000776;ITAÚ ADMINISTRADORA DE CONSÓRCIOS LTDA.;Irregularidades relacionadas às condições para contemplação por lance ou sorteio;1;2;0;3;
2023;1º;00000776;ITAÚ ADMINISTRADORA DE CONSÓRCIOS LTDA.;Irregularidades relativas a integridade, confiabilidade, segurança, sigilo ou legitimidade das operações e serviços prestados relacionados a administradora de consórcio;64;35;0;99;
2023;1º;00000776;ITAÚ ADMINISTRADORA DE CONSÓRCIOS LTDA.;Não fornecimento, remessa ou divulgação de documentos por parte de administradora de consórcio;3;4;0;7;
2023;1º;00000776;ITAÚ ADMINISTRADORA DE CONSÓRCIOS LTDA.;Oferta ou prestação de informação a respeito de produtos e serviços de forma inadequada por administradora de consórcio;16;13;0;29;
2023;1º;00000776;ITAÚ ADMINISTRADORA DE CONSÓRCIOS LTDA.;Outras irregularidades;1;0;0;1;
2023;1º;00000776;ITAÚ ADMINISTRADORA DE CONSÓRCIOS LTDA.;Outras irregularidades relacionadas à Ouvidoria;0;1;0;1;
2023;1º;00000776;ITAÚ ADMINISTRADORA DE CONSÓRCIOS LTDA.;Reclamações relacionadas a assuntos diversos;0;0;7;7;
2023;1º;00000776;ITAÚ ADMINISTRADORA DE CONSÓRCIOS LTDA.;Recusa de produtos ou serviços - Consórcio;0;0;2;2;
2023;1º;00000776;ITAÚ ADMINISTRADORA DE CONSÓRCIOS LTDA.;Renegociação de dívida - Consórcio;0;0;2;2;
2023;1º;37137767;JORLAN ADMINISTRADORA DE CONSÓRCIO LTDA.;Irregularidades relacionadas a informações e liquidação de valores a receber no sistema SVR do BCB por parte de consórcios;0;1;0;1;
2023;1º;60250776;LUIZA ADMINISTRADORA DE CONSÓRCIOS LTDA;Irregularidades relacionadas a informações e liquidação de valores a receber no sistema SVR do BCB por parte de consórcios;0;1;0;1;
2023;1º;60250776;LUIZA ADMINISTRADORA DE CONSÓRCIOS LTDA;Irregularidades relacionadas à liberação do crédito;0;2;0;2;
2023;1º;60250776;LUIZA ADMINISTRADORA DE CONSÓRCIOS LTDA;Irregularidades relacionadas às condições para contemplação por lance ou sorteio;0;2;0;2;
2023;1º;60250776;LUIZA ADMINISTRADORA DE CONSÓRCIOS LTDA;Irregularidades relativas a integridade, confiabilidade, segurança, sigilo ou legitimidade das operações e serviços prestados relacionados a administradora de consórcio;0;4;0;4;
2023;1º;60250776;LUIZA ADMINISTRADORA DE CONSÓRCIOS LTDA;Oferta ou prestação de informação a respeito de produtos e serviços de forma inadequada por administradora de consórcio;1;0;0;1;
2023;1º;04250224;MAGGI ADMINISTRADORA DE CONSÓRCIOS LTDA;Irregularidades relacionadas à liberação do crédito;0;1;0;1;
2023;1º;04250224;MAGGI ADMINISTRADORA DE CONSÓRCIOS LTDA;Irregularidades relativas a integridade, confiabilidade, segurança, sigilo ou legitimidade das operações e serviços prestados relacionados a administradora de consórcio;1;0;0;1;
2023;1º;04250224;MAGGI ADMINISTRADORA DE CONSÓRCIOS LTDA;Recusa de produtos ou serviços - Consórcio;0;0;1;1;
2023;1º;76853043;MENEGALLI ADMINISTRADORA DE CONSÓRCIOS LTDA;Descumprimento de cláusulas referentes à devolução de valores;0;1;0;1;
2023;1º;76853043;MENEGALLI ADMINISTRADORA DE CONSÓRCIOS LTDA;Irregularidades relacionadas a informações e liquidação de valores a receber no sistema SVR do BCB por parte de consórcios;0;1;0;1;
2023;1º;46349106;MERCABENCO ADMINISTRADORA DE CONSORCIO LTDA;Descumprimento de cláusulas referentes à devolução de valores;0;1;0;1;
2023;1º;46349106;MERCABENCO ADMINISTRADORA DE CONSORCIO LTDA;Descumprimento de obrigações previstas em contratos;0;1;0;1;
2023;1º;46349106;MERCABENCO ADMINISTRADORA DE CONSORCIO LTDA;Irregularidades relacionadas à liberação do crédito;0;1;0;1;
2023;1º;46349106;MERCABENCO ADMINISTRADORA DE CONSORCIO LTDA;Irregularidades relacionadas às condições para contemplação por lance ou sorteio;0;1;0;1;
2023;1º;46349106;MERCABENCO ADMINISTRADORA DE CONSORCIO LTDA;Irregularidades relativas a integridade, confiabilidade, segurança, sigilo ou legitimidade das operações e serviços prestados relacionados a administradora de consórcio;2;0;0;2;
2023;1º;05126027;MOTOASA ADMINISTRADORA DE CONSÓRCIOS LTDA.;Irregularidades relativas a integridade, confiabilidade, segurança, sigilo ou legitimidade das operações e serviços prestados relacionados a administradora de consórcio;0;1;0;1;
2023;1º;04124922;MULTIMARCAS ADMINISTRADORA DE CONSORCIOS LTDA.;Descumprimento de cláusulas referentes à devolução de valores;0;11;0;11;
2023;1º;04124922;MULTIMARCAS ADMINISTRADORA DE CONSORCIOS LTDA.;Descumprimento de obrigações previstas em contratos;0;1;0;1;
2023;1º;04124922;MULTIMARCAS ADMINISTRADORA DE CONSORCIOS LTDA.;Falta de transparência na redação de documentos por parte de administradora de consórcio;1;0;0;1;
2023;1º;04124922;MULTIMARCAS ADMINISTRADORA DE CONSORCIOS LTDA.;Insatisfação com a resposta fornecida pela administradora de consórcio relativa à demanda registrada contra ela;0;3;0;3;
2023;1º;04124922;MULTIMARCAS ADMINISTRADORA DE CONSORCIOS LTDA.;Insatisfação por parte do cliente com o atendimento prestado pela administradora de consórcio;0;0;1;1;
2023;1º;04124922;MULTIMARCAS ADMINISTRADORA DE CONSORCIOS LTDA.;Irregularidades relacionadas a informações e liquidação de valores a receber no sistema SVR do BCB por parte de consórcios;10;0;0;10;
2023;1º;04124922;MULTIMARCAS ADMINISTRADORA DE CONSORCIOS LTDA.;Irregularidades relacionadas às condições para contemplação por lance ou sorteio;0;3;0;3;
2023;1º;04124922;MULTIMARCAS ADMINISTRADORA DE CONSORCIOS LTDA.;Irregularidades relativas a integridade, confiabilidade, segurança, sigilo ou legitimidade das operações e serviços prestados relacionados a administradora de consórcio;1;2;0;3;
2023;1º;04124922;MULTIMARCAS ADMINISTRADORA DE CONSORCIOS LTDA.;Oferta ou prestação de informação a respeito de produtos e serviços de forma inadequada por administradora de consórcio;22;8;0;30;
2023;1º;05395814;NOVOTEMPO ADMINISTRADORA DE CONSORCIOS LTDA.;Descumprimento de obrigações previstas em contratos;0;1;0;1;
2023;1º;50533876;PAN ADMINISTRADORA DE CONSORCIO LTDA;Descumprimento de cláusulas referentes à devolução de valores;0;1;0;1;
2023;1º;50533876;PAN ADMINISTRADORA DE CONSORCIO LTDA;Irregularidades relacionadas a informações e liquidação de valores a receber no sistema SVR do BCB por parte de consórcios;1;1;0;2;
2023;1º;50533876;PAN ADMINISTRADORA DE CONSORCIO LTDA;Irregularidades relativas a integridade, confiabilidade, segurança, sigilo ou legitimidade das operações e serviços prestados relacionados a administradora de consórcio;1;0;0;1;
2023;1º;48041735;PORTO SEGURO ADMINISTRADORA DE CONSÓRCIOS LTDA;Ausência de transparência nas relações contratuais;0;0;1;1;
2023;1º;48041735;PORTO SEGURO ADMINISTRADORA DE CONSÓRCIOS LTDA;Cancelamento de contrato a pedido do cliente não atendido por administradora de consórcio;4;2;0;6;
2023;1º;48041735;PORTO SEGURO ADMINISTRADORA DE CONSÓRCIOS LTDA;Cobranças Diversas - Consórcio;0;0;2;2;
2023;1º;48041735;PORTO SEGURO ADMINISTRADORA DE CONSÓRCIOS LTDA;Descumprimento de cláusulas referentes à devolução de valores;9;19;0;28;
2023;1º;48041735;PORTO SEGURO ADMINISTRADORA DE CONSÓRCIOS LTDA;Descumprimento de obrigações previstas em contratos;1;4;0;5;
2023;1º;48041735;PORTO SEGURO ADMINISTRADORA DE CONSÓRCIOS LTDA;Descumprimento de prazo de resposta a demanda;1;1;0;2;
2023;1º;48041735;PORTO SEGURO ADMINISTRADORA DE CONSÓRCIOS LTDA;Falta de transparência na redação de documentos por parte de administradora de consórcio;1;0;0;1;
2023;1º;48041735;PORTO SEGURO ADMINISTRADORA DE CONSÓRCIOS LTDA;Insatisfação com a resposta fornecida pela administradora de consórcio relativa à demanda registrada contra ela;2;9;0;11;
2023;1º;48041735;PORTO SEGURO ADMINISTRADORA DE CONSÓRCIOS LTDA;Insatisfação por parte do cliente com o atendimento prestado pela administradora de consórcio;0;0;3;3;
2023;1º;48041735;PORTO SEGURO ADMINISTRADORA DE CONSÓRCIOS LTDA;Irregularidades relacionadas a informações e liquidação de valores a receber no sistema SVR do BCB por parte de consórcios;60;20;0;80;
2023;1º;48041735;PORTO SEGURO ADMINISTRADORA DE CONSÓRCIOS LTDA;Irregularidades relacionadas à liberação do crédito;25;17;0;42;
2023;1º;48041735;PORTO SEGURO ADMINISTRADORA DE CONSÓRCIOS LTDA;Irregularidades relacionadas às condições para contemplação por lance ou sorteio;0;2;0;2;
2023;1º;48041735;PORTO SEGURO ADMINISTRADORA DE CONSÓRCIOS LTDA;Irregularidades relativas a integridade, confiabilidade, segurança, sigilo ou legitimidade das operações e serviços prestados relacionados a administradora de consórcio;104;32;0;136;
2023;1º;48041735;PORTO SEGURO ADMINISTRADORA DE CONSÓRCIOS LTDA;Não fornecimento, remessa ou divulgação de documentos por parte de administradora de consórcio;7;4;0;11;
2023;1º;48041735;PORTO SEGURO ADMINISTRADORA DE CONSÓRCIOS LTDA;Oferta ou prestação de informação a respeito de produtos e serviços de forma inadequada por administradora de consórcio;12;5;0;17;
2023;1º;48041735;PORTO SEGURO ADMINISTRADORA DE CONSÓRCIOS LTDA;Outras irregularidades relacionadas à Ouvidoria;1;0;0;1;
2023;1º;48041735;PORTO SEGURO ADMINISTRADORA DE CONSÓRCIOS LTDA;Reclamações relacionadas a assuntos diversos;0;0;2;2;
2023;1º;48041735;PORTO SEGURO ADMINISTRADORA DE CONSÓRCIOS LTDA;Recusa de produtos ou serviços - Consórcio;0;0;3;3;
2023;1º;48041735;PORTO SEGURO ADMINISTRADORA DE CONSÓRCIOS LTDA;Renegociação de dívida - Consórcio;0;0;2;2;
2023;1º;87433413;PORTOBENS ADMINISTRADORA DE CONSORCIOS LTDA;Descumprimento de obrigações previstas em contratos;1;1;0;2;
2023;1º;87433413;PORTOBENS ADMINISTRADORA DE CONSORCIOS LTDA;Irregularidades relacionadas às condições para contemplação por lance ou sorteio;0;2;0;2;
2023;1º;87433413;PORTOBENS ADMINISTRADORA DE CONSORCIOS LTDA;Irregularidades relativas a integridade, confiabilidade, segurança, sigilo ou legitimidade das operações e serviços prestados relacionados a administradora de consórcio;0;1;0;1;
2023;1º;87433413;PORTOBENS ADMINISTRADORA DE CONSORCIOS LTDA;Reclamações relacionadas a assuntos diversos;0;0;1;1;
2023;1º;51597300;PRIMO ROSSI ADMINISTRADORA DE CONSÓRCIO LTDA.;Descumprimento de cláusulas referentes à devolução de valores;0;2;0;2;
2023;1º;51597300;PRIMO ROSSI ADMINISTRADORA DE CONSÓRCIO LTDA.;Irregularidades relativas a integridade, confiabilidade, segurança, sigilo ou legitimidade das operações e serviços prestados relacionados a administradora de consórcio;1;1;0;2;
2023;1º;09111444;PROMOVE ADMINISTRADORA DE CONSÓRCIO LTDA.;Cancelamento de contrato a pedido do cliente não atendido por administradora de consórcio;1;1;0;2;
2023;1º;09111444;PROMOVE ADMINISTRADORA DE CONSÓRCIO LTDA.;Insatisfação com a resposta fornecida pela administradora de consórcio relativa à demanda registrada contra ela;0;1;0;1;
2023;1º;09111444;PROMOVE ADMINISTRADORA DE CONSÓRCIO LTDA.;Irregularidades relativas a integridade, confiabilidade, segurança, sigilo ou legitimidade das operações e serviços prestados relacionados a administradora de consórcio;1;0;0;1;
2023;1º;09111444;PROMOVE ADMINISTRADORA DE CONSÓRCIO LTDA.;Oferta ou prestação de informação a respeito de produtos e serviços de forma inadequada por administradora de consórcio;16;3;0;19;
2023;1º;91108027;RANDON ADMINISTRADORA DE CONSÓRCIOS LTDA.;Irregularidades relacionadas à liberação do crédito;0;1;0;1;
2023;1º;91108027;RANDON ADMINISTRADORA DE CONSÓRCIOS LTDA.;Irregularidades relacionadas às condições para contemplação por lance ou sorteio;0;1;0;1;
2023;1º;91108027;RANDON ADMINISTRADORA DE CONSÓRCIOS LTDA.;Restrições cadastrais - Consórcio;0;0;1;1;
2023;1º;06181431;RCN ADMINISTRADORA DE CONSORCIO NACIONAL LTDA;Irregularidades relativas a integridade, confiabilidade, segurança, sigilo ou legitimidade das operações e serviços prestados relacionados a administradora de consórcio;0;1;0;1;
2023;1º;06181431;RCN ADMINISTRADORA DE CONSORCIO NACIONAL LTDA;Oferta ou prestação de informação a respeito de produtos e serviços de forma inadequada por administradora de consórcio;7;0;0;7;
2023;1º;06181431;RCN ADMINISTRADORA DE CONSORCIO NACIONAL LTDA;Reclamações relacionadas a assuntos diversos;0;0;1;1;
2023;1º;23767155;RECON ADMINISTRADORA DE CONSORCIOS LTDA;Descumprimento de cláusulas referentes à devolução de valores;0;4;0;4;
2023;1º;23767155;RECON ADMINISTRADORA DE CONSORCIOS LTDA;Insatisfação por parte do cliente com o atendimento prestado pela administradora de consórcio;0;0;1;1;
2023;1º;23767155;RECON ADMINISTRADORA DE CONSORCIOS LTDA;Irregularidades relacionadas à liberação do crédito;1;1;0;2;
2023;1º;23767155;RECON ADMINISTRADORA DE CONSORCIOS LTDA;Não fornecimento, remessa ou divulgação de documentos por parte de administradora de consórcio;1;1;0;2;
2023;1º;23767155;RECON ADMINISTRADORA DE CONSORCIOS LTDA;Oferta ou prestação de informação a respeito de produtos e serviços de forma inadequada por administradora de consórcio;2;1;0;3;
2023;1º;62246228;REDENÇÃO ADMINISTRADORA DE CONSÓRCIO LTDA.;Descumprimento de obrigações previstas em contratos;0;1;0;1;
2023;1º;62246228;REDENÇÃO ADMINISTRADORA DE CONSÓRCIO LTDA.;Falta de transparência na redação de documentos por parte de administradora de consórcio;1;0;0;1;
2023;1º;62246228;REDENÇÃO ADMINISTRADORA DE CONSÓRCIO LTDA.;Não fornecimento, remessa ou divulgação de documentos por parte de administradora de consórcio;1;1;0;2;
2023;1º;62354055;REMAZA ADMINISTRADORA DE CONSÓRCIO LTDA.;Descumprimento de cláusulas referentes à devolução de valores;0;2;0;2;
2023;1º;62354055;REMAZA ADMINISTRADORA DE CONSÓRCIO LTDA.;Irregularidades relacionadas a informações e liquidação de valores a receber no sistema SVR do BCB por parte de consórcios;0;2;0;2;
2023;1º;62354055;REMAZA ADMINISTRADORA DE CONSÓRCIO LTDA.;Oferta ou prestação de informação a respeito de produtos e serviços de forma inadequada por administradora de consórcio;2;4;0;6;
2023;1º;28904092;RESERVA ADMINISTRADORA DE CONSÓRCIO LTDA;Descumprimento de cláusulas referentes à devolução de valores;0;4;0;4;
2023;1º;28904092;RESERVA ADMINISTRADORA DE CONSÓRCIO LTDA;Insatisfação com a resposta fornecida pela administradora de consórcio relativa à demanda registrada contra ela;0;2;0;2;
2023;1º;28904092;RESERVA ADMINISTRADORA DE CONSÓRCIO LTDA;Insatisfação por parte do cliente com o atendimento prestado pela administradora de consórcio;0;0;2;2;
2023;1º;28904092;RESERVA ADMINISTRADORA DE CONSÓRCIO LTDA;Irregularidades relacionadas à liberação do crédito;1;0;0;1;
2023;1º;28904092;RESERVA ADMINISTRADORA DE CONSÓRCIO LTDA;Não fornecimento, remessa ou divulgação de documentos por parte de administradora de consórcio;1;1;0;2;
2023;1º;28904092;RESERVA ADMINISTRADORA DE CONSÓRCIO LTDA;Oferta ou prestação de informação a respeito de produtos e serviços de forma inadequada por administradora de consórcio;19;8;0;27;
2023;1º;28904092;RESERVA ADMINISTRADORA DE CONSÓRCIO LTDA;Outras irregularidades relacionadas à Ouvidoria;1;0;0;1;
2023;1º;51855716;RODOBENS ADMINISTRADORA DE CONSÓRCIOS LTDA.;Cancelamento de contrato a pedido do cliente não atendido por administradora de consórcio;1;0;0;1;
2023;1º;51855716;RODOBENS ADMINISTRADORA DE CONSÓRCIOS LTDA.;Descumprimento de cláusulas referentes à devolução de valores;0;8;0;8;
2023;1º;51855716;RODOBENS ADMINISTRADORA DE CONSÓRCIOS LTDA.;Descumprimento de obrigações previstas em contratos;0;2;0;2;
2023;1º;51855716;RODOBENS ADMINISTRADORA DE CONSÓRCIOS LTDA.;Insatisfação com a resposta fornecida pela administradora de consórcio relativa à demanda registrada contra ela;0;2;0;2;
2023;1º;51855716;RODOBENS ADMINISTRADORA DE CONSÓRCIOS LTDA.;Insatisfação por parte do cliente com o atendimento prestado pela administradora de consórcio;0;0;2;2;
2023;1º;51855716;RODOBENS ADMINISTRADORA DE CONSÓRCIOS LTDA.;Irregularidades relacionadas a informações e liquidação de valores a receber no sistema SVR do BCB por parte de consórcios;2;6;0;8;
2023;1º;51855716;RODOBENS ADMINISTRADORA DE CONSÓRCIOS LTDA.;Irregularidades relacionadas à liberação do crédito;0;5;0;5;
2023;1º;51855716;RODOBENS ADMINISTRADORA DE CONSÓRCIOS LTDA.;Irregularidades relacionadas às condições para contemplação por lance ou sorteio;0;2;0;2;
2023;1º;51855716;RODOBENS ADMINISTRADORA DE CONSÓRCIOS LTDA.;Irregularidades relativas a integridade, confiabilidade, segurança, sigilo ou legitimidade das operações e serviços prestados relacionados a administradora de consórcio;12;15;0;27;
2023;1º;51855716;RODOBENS ADMINISTRADORA DE CONSÓRCIOS LTDA.;Não fornecimento, remessa ou divulgação de documentos por parte de administradora de consórcio;2;3;0;5;
2023;1º;51855716;RODOBENS ADMINISTRADORA DE CONSÓRCIOS LTDA.;Oferta ou prestação de informação a respeito de produtos e serviços de forma inadequada por administradora de consórcio;6;1;0;7;
2023;1º;51855716;RODOBENS ADMINISTRADORA DE CONSÓRCIOS LTDA.;Reclamações relacionadas a assuntos diversos;0;0;4;4;
2023;1º;51855716;RODOBENS ADMINISTRADORA DE CONSÓRCIOS LTDA.;Renegociação de dívida - Consórcio;0;0;2;2;
2023;1º;55942312;SANTANDER BRASIL ADMINISTRADORA DE CONSÓRCIO LTDA.;Ausência de transparência nas relações contratuais;0;0;1;1;
2023;1º;55942312;SANTANDER BRASIL ADMINISTRADORA DE CONSÓRCIO LTDA.;Cancelamento de contrato a pedido do cliente não atendido por administradora de consórcio;1;0;0;1;
2023;1º;55942312;SANTANDER BRASIL ADMINISTRADORA DE CONSÓRCIO LTDA.;Descumprimento de cláusulas referentes à devolução de valores;6;29;0;35;
2023;1º;55942312;SANTANDER BRASIL ADMINISTRADORA DE CONSÓRCIO LTDA.;Descumprimento de obrigações previstas em contratos;2;16;0;18;
2023;1º;55942312;SANTANDER BRASIL ADMINISTRADORA DE CONSÓRCIO LTDA.;Insatisfação com a resposta fornecida pela administradora de consórcio relativa à demanda registrada contra ela;7;11;0;18;
2023;1º;55942312;SANTANDER BRASIL ADMINISTRADORA DE CONSÓRCIO LTDA.;Insatisfação por parte do cliente com o atendimento prestado pela administradora de consórcio;0;0;3;3;
2023;1º;55942312;SANTANDER BRASIL ADMINISTRADORA DE CONSÓRCIO LTDA.;Irregularidades relacionadas a informações e liquidação de valores a receber no sistema SVR do BCB por parte de consórcios;4;3;0;7;
2023;1º;55942312;SANTANDER BRASIL ADMINISTRADORA DE CONSÓRCIO LTDA.;Irregularidades relacionadas à liberação do crédito;19;58;0;77;
2023;1º;55942312;SANTANDER BRASIL ADMINISTRADORA DE CONSÓRCIO LTDA.;Irregularidades relacionadas às condições para contemplação por lance ou sorteio;0;2;0;2;
2023;1º;55942312;SANTANDER BRASIL ADMINISTRADORA DE CONSÓRCIO LTDA.;Irregularidades relativas a integridade, confiabilidade, segurança, sigilo ou legitimidade das operações e serviços prestados relacionados a administradora de consórcio;116;59;0;175;
2023;1º;55942312;SANTANDER BRASIL ADMINISTRADORA DE CONSÓRCIO LTDA.;Não fornecimento, remessa ou divulgação de documentos por parte de administradora de consórcio;6;7;0;13;
2023;1º;55942312;SANTANDER BRASIL ADMINISTRADORA DE CONSÓRCIO LTDA.;Oferta ou prestação de informação a respeito de produtos e serviços de forma inadequada por administradora de consórcio;22;6;0;28;
2023;1º;55942312;SANTANDER BRASIL ADMINISTRADORA DE CONSÓRCIO LTDA.;Reclamações relacionadas a assuntos diversos;0;0;7;7;
2023;1º;55942312;SANTANDER BRASIL ADMINISTRADORA DE CONSÓRCIO LTDA.;Renegociação de dívida - Consórcio;0;0;1;1;
2023;1º;96479258;SCANIA ADMINISTRADORA DE CONSÓRCIOS LTDA.;Descumprimento de prazo de resposta a demanda;0;1;0;1;
2023;1º;96479258;SCANIA ADMINISTRADORA DE CONSÓRCIOS LTDA.;Irregularidades relativas a integridade, confiabilidade, segurança, sigilo ou legitimidade das operações e serviços prestados relacionados a administradora de consórcio;0;4;0;4;
2023;1º;76515071;SERVOPA ADMINISTRADORA DE CONSORCIOS LTDA;Descumprimento de cláusulas referentes à devolução de valores;0;2;0;2;
2023;1º;76515071;SERVOPA ADMINISTRADORA DE CONSORCIOS LTDA;Irregularidades relacionadas a informações e liquidação de valores a receber no sistema SVR do BCB por parte de consórcios;0;1;0;1;
2023;1º;76515071;SERVOPA ADMINISTRADORA DE CONSORCIOS LTDA;Irregularidades relativas a integridade, confiabilidade, segurança, sigilo ou legitimidade das operações e serviços prestados relacionados a administradora de consórcio;1;0;0;1;
2023;1º;16551061;SICOOB ADMINISTRADORA DE CONSÓRCIOS LTDA.;Ausência de transparência nas relações contratuais;0;0;1;1;
2023;1º;16551061;SICOOB ADMINISTRADORA DE CONSÓRCIOS LTDA.;Cobrança irregular de tarifa pela emissão de boletos, carnês e assemelhados;0;2;0;2;
2023;1º;16551061;SICOOB ADMINISTRADORA DE CONSÓRCIOS LTDA.;Descumprimento de cláusulas referentes à devolução de valores;3;2;0;5;
2023;1º;16551061;SICOOB ADMINISTRADORA DE CONSÓRCIOS LTDA.;Descumprimento de obrigações previstas em contratos;0;7;0;7;
2023;1º;16551061;SICOOB ADMINISTRADORA DE CONSÓRCIOS LTDA.;Insatisfação com a resposta fornecida pela administradora de consórcio relativa à demanda registrada contra ela;0;1;0;1;
2023;1º;16551061;SICOOB ADMINISTRADORA DE CONSÓRCIOS LTDA.;Insatisfação por parte do cliente com o atendimento prestado pela administradora de consórcio;0;0;1;1;
2023;1º;16551061;SICOOB ADMINISTRADORA DE CONSÓRCIOS LTDA.;Irregularidades relacionadas a informações e liquidação de valores a receber no sistema SVR do BCB por parte de consórcios;1;0;0;1;
2023;1º;16551061;SICOOB ADMINISTRADORA DE CONSÓRCIOS LTDA.;Irregularidades relacionadas à liberação do crédito;0;8;0;8;
2023;1º;16551061;SICOOB ADMINISTRADORA DE CONSÓRCIOS LTDA.;Irregularidades relativas a integridade, confiabilidade, segurança, sigilo ou legitimidade das operações e serviços prestados relacionados a administradora de consórcio;7;7;0;14;
2023;1º;16551061;SICOOB ADMINISTRADORA DE CONSÓRCIOS LTDA.;Não fornecimento, remessa ou divulgação de documentos por parte de administradora de consórcio;1;2;0;3;
2023;1º;16551061;SICOOB ADMINISTRADORA DE CONSÓRCIOS LTDA.;Oferta ou prestação de informação a respeito de produtos e serviços de forma inadequada por administradora de consórcio;1;0;0;1;
2023;1º;16551061;SICOOB ADMINISTRADORA DE CONSÓRCIOS LTDA.;Reclamações relacionadas a assuntos diversos;0;0;1;1;
2023;1º;16551061;SICOOB ADMINISTRADORA DE CONSÓRCIOS LTDA.;Recusa de produtos ou serviços - Consórcio;0;0;1;1;
2023;1º;87945218;SIMPALA LANÇADORA E ADMINISTRADORA DE CONSÓRCIOS LTDA.;Insatisfação com a resposta fornecida pela administradora de consórcio relativa à demanda registrada contra ela;0;1;0;1;
2023;1º;87945218;SIMPALA LANÇADORA E ADMINISTRADORA DE CONSÓRCIOS LTDA.;Insatisfação por parte do cliente com o atendimento prestado pela administradora de consórcio;0;0;1;1;
2023;1º;87945218;SIMPALA LANÇADORA E ADMINISTRADORA DE CONSÓRCIOS LTDA.;Irregularidades relativas a integridade, confiabilidade, segurança, sigilo ou legitimidade das operações e serviços prestados relacionados a administradora de consórcio;1;0;0;1;
2023;1º;87945218;SIMPALA LANÇADORA E ADMINISTRADORA DE CONSÓRCIOS LTDA.;Não fornecimento, remessa ou divulgação de documentos por parte de administradora de consórcio;0;1;0;1;
2023;1º;87945218;SIMPALA LANÇADORA E ADMINISTRADORA DE CONSÓRCIOS LTDA.;Oferta ou prestação de informação a respeito de produtos e serviços de forma inadequada por administradora de consórcio;8;2;0;10;
2023;1º;87945218;SIMPALA LANÇADORA E ADMINISTRADORA DE CONSÓRCIOS LTDA.;Reclamações relacionadas a assuntos diversos;0;0;1;1;
2023;1º;87852273;SINOSSERRA ADMINISTRADORA DE CONSÓRCIOS LTDA;Irregularidades relacionadas a informações e liquidação de valores a receber no sistema SVR do BCB por parte de consórcios;1;0;0;1;
2023;1º;04058605;SOLUÇÃO ADMINISTRADORA DE CONSÓRCIOS LTDA.;Irregularidades relativas a integridade, confiabilidade, segurança, sigilo ou legitimidade das operações e serviços prestados relacionados a administradora de consórcio;1;0;0;1;
2023;1º;87636635;SPONCHIADO ADMINISTRADORA DE CONSÓRCIOS LTDA.;Irregularidades relacionadas a informações e liquidação de valores a receber no sistema SVR do BCB por parte de consórcios;1;0;0;1;
2023;1º;87636635;SPONCHIADO ADMINISTRADORA DE CONSÓRCIOS LTDA.;Renegociação de dívida - Consórcio;0;0;1;1;
2023;1º;53211488;TARRAF ADMINISTRADORA DE CONSÓRCIOS LTDA.;Não fornecimento, remessa ou divulgação de documentos por parte de administradora de consórcio;0;1;0;1;
2023;1º;05551841;TÁGIDE ADMINISTRADORA DE CONSÓRCIOS LTDA.;Oferta ou prestação de informação a respeito de produtos e serviços de forma inadequada por administradora de consórcio;1;0;0;1;
2023;1º;43707203;TOYOTA ADMINISTRADORA DE CONSÓRCIOS DO BRASIL LTDA.;Oferta ou prestação de informação a respeito de produtos e serviços de forma inadequada por administradora de consórcio;0;1;0;1;
2023;1º;59956185;TRADIÇÃO ADMINISTRADORA DE CONSÓRCIO LTDA.;Descumprimento de cláusulas referentes à devolução de valores;0;2;0;2;
2023;1º;59956185;TRADIÇÃO ADMINISTRADORA DE CONSÓRCIO LTDA.;Irregularidades relacionadas a informações e liquidação de valores a receber no sistema SVR do BCB por parte de consórcios;0;1;0;1;
2023;1º;59956185;TRADIÇÃO ADMINISTRADORA DE CONSÓRCIO LTDA.;Irregularidades relativas a integridade, confiabilidade, segurança, sigilo ou legitimidade das operações e serviços prestados relacionados a administradora de consórcio;3;1;0;4;
2023;1º;59956185;TRADIÇÃO ADMINISTRADORA DE CONSÓRCIO LTDA.;Oferta ou prestação de informação a respeito de produtos e serviços de forma inadequada por administradora de consórcio;11;2;0;13;
2023;1º;59956185;TRADIÇÃO ADMINISTRADORA DE CONSÓRCIO LTDA.;Reclamações relacionadas a assuntos diversos;0;0;1;1;
2023;1º;83553883;UNIÃO CATARINENSE ADMINISTRADORA DE CONSORCIOS LTDA;Cancelamento de contrato a pedido do cliente não atendido por administradora de consórcio;1;0;0;1;
2023;1º;60732997;UNIFISA ADMINISTRADORA NACIONAL DE CONSORCIOS LTDA;Insatisfação com a resposta fornecida pela administradora de consórcio relativa à demanda registrada contra ela;1;0;0;1;
2023;1º;60732997;UNIFISA ADMINISTRADORA NACIONAL DE CONSORCIOS LTDA;Irregularidades relacionadas a informações e liquidação de valores a receber no sistema SVR do BCB por parte de consórcios;1;0;0;1;
2023;1º;60732997;UNIFISA ADMINISTRADORA NACIONAL DE CONSORCIOS LTDA;Irregularidades relacionadas à liberação do crédito;0;1;0;1;
2023;1º;60732997;UNIFISA ADMINISTRADORA NACIONAL DE CONSORCIOS LTDA;Irregularidades relativas a integridade, confiabilidade, segurança, sigilo ou legitimidade das operações e serviços prestados relacionados a administradora de consórcio;4;1;0;5;
2023;1º;60732997;UNIFISA ADMINISTRADORA NACIONAL DE CONSORCIOS LTDA;Irregularidades relativas a telemarketing, SMS ou WhatsApp com oferta de Consórcio;0;0;1;1;
2023;1º;60732997;UNIFISA ADMINISTRADORA NACIONAL DE CONSORCIOS LTDA;Não fornecimento, remessa ou divulgação de documentos por parte de administradora de consórcio;1;1;0;2;
2023;1º;60732997;UNIFISA ADMINISTRADORA NACIONAL DE CONSORCIOS LTDA;Oferta ou prestação de informação a respeito de produtos e serviços de forma inadequada por administradora de consórcio;3;1;0;4;
2023;1º;60732997;UNIFISA ADMINISTRADORA NACIONAL DE CONSORCIOS LTDA;Reclamações relacionadas a assuntos diversos;0;0;1;1;
2023;1º;60732997;UNIFISA ADMINISTRADORA NACIONAL DE CONSORCIOS LTDA;Recusa de produtos ou serviços - Consórcio;0;0;1;1;
2023;1º;56360266;VALTRA ADMINISTRADORA DE CONSÓRCIOS LTDA;Recusa de produtos ou serviços - Consórcio;0;0;1;1;
2023;1º;45594223;VEMAR ADMINISTRADORA DE CONSÓRCIO LTDA.;Irregularidades relacionadas a informações e liquidação de valores a receber no sistema SVR do BCB por parte de consórcios;3;1;0;4;
2023;1º;50827237;VKN ADMINISTRADORA DE CONSÓRCIO LTDA.;Insatisfação com a resposta fornecida pela administradora de consórcio relativa à demanda registrada contra ela;0;1;0;1;
2023;1º;50827237;VKN ADMINISTRADORA DE CONSÓRCIO LTDA.;Irregularidades relacionadas a informações e liquidação de valores a receber no sistema SVR do BCB por parte de consórcios;1;0;0;1;
2023;1º;50827237;VKN ADMINISTRADORA DE CONSÓRCIO LTDA.;Irregularidades relacionadas à liberação do crédito;5;0;0;5;
2023;1º;50827237;VKN ADMINISTRADORA DE CONSÓRCIO LTDA.;Reclamações relacionadas a assuntos diversos;0;0;1;1;
2023;1º;74118381;VOLVO ADMINISTRADORA DE CONSÓRCIO LTDA.;Descumprimento de cláusulas referentes à devolução de valores;0;1;0;1;
2023;1º;74118381;VOLVO ADMINISTRADORA DE CONSÓRCIO LTDA.;Irregularidades relacionadas às condições para contemplação por lance ou sorteio;0;1;0;1;
2023;1º;74118381;VOLVO ADMINISTRADORA DE CONSÓRCIO LTDA.;Irregularidades relativas a integridade, confiabilidade, segurança, sigilo ou legitimidade das operações e serviços prestados relacionados a administradora de consórcio;1;0;0;1;
2023;1º;40011095;XS5 ADMINISTRADORA DE CONSÓRCIOS S.A.;Cancelamento de contrato a pedido do cliente não atendido por administradora de consórcio;1;0;0;1;
2023;1º;40011095;XS5 ADMINISTRADORA DE CONSÓRCIOS S.A.;Descumprimento de obrigações previstas em contratos;0;1;0;1;
2023;1º;40011095;XS5 ADMINISTRADORA DE CONSÓRCIOS S.A.;Insatisfação com a resposta fornecida pela administradora de consórcio relativa à demanda registrada contra ela;1;0;0;1;
2023;1º;40011095;XS5 ADMINISTRADORA DE CONSÓRCIOS S.A.;Insatisfação por parte do cliente com o atendimento prestado pela administradora de consórcio;0;0;1;1;
2023;1º;40011095;XS5 ADMINISTRADORA DE CONSÓRCIOS S.A.;Irregularidades relacionadas à liberação do crédito;7;7;0;14;
2023;1º;40011095;XS5 ADMINISTRADORA DE CONSÓRCIOS S.A.;Irregularidades relacionadas às condições para contemplação por lance ou sorteio;0;1;0;1;
2023;1º;40011095;XS5 ADMINISTRADORA DE CONSÓRCIOS S.A.;Irregularidades relativas a integridade, confiabilidade, segurança, sigilo ou legitimidade das operações e serviços prestados relacionados a administradora de consórcio;22;2;0;24;
2023;1º;40011095;XS5 ADMINISTRADORA DE CONSÓRCIOS S.A.;Oferta ou prestação de informação a respeito de produtos e serviços de forma inadequada por administradora de consórcio;4;0;0;4;
2023;1º;47458153;YAMAHA ADMINISTRADORA DE CONSÓRCIO LTDA.;Ausência de transparência nas relações contratuais;0;0;1;1;
2023;1º;47458153;YAMAHA ADMINISTRADORA DE CONSÓRCIO LTDA.;Descumprimento de cláusulas referentes à devolução de valores;0;2;0;2;
2023;1º;47458153;YAMAHA ADMINISTRADORA DE CONSÓRCIO LTDA.;Descumprimento de obrigações previstas em contratos;1;1;0;2;
2023;1º;47458153;YAMAHA ADMINISTRADORA DE CONSÓRCIO LTDA.;Descumprimento de prazo de resposta a demanda;0;1;0;1;
2023;1º;47458153;YAMAHA ADMINISTRADORA DE CONSÓRCIO LTDA.;Insatisfação com a resposta fornecida pela administradora de consórcio relativa à demanda registrada contra ela;0;1;0;1;
2023;1º;47458153;YAMAHA ADMINISTRADORA DE CONSÓRCIO LTDA.;Insatisfação por parte do cliente com o atendimento prestado pela administradora de consórcio;0;0;1;1;
2023;1º;47458153;YAMAHA ADMINISTRADORA DE CONSÓRCIO LTDA.;Irregularidades relacionadas a informações e liquidação de valores a receber no sistema SVR do BCB por parte de consórcios;3;4;0;7;
2023;1º;47458153;YAMAHA ADMINISTRADORA DE CONSÓRCIO LTDA.;Irregularidades relacionadas à liberação do crédito;0;1;0;1;
2023;1º;47458153;YAMAHA ADMINISTRADORA DE CONSÓRCIO LTDA.;Irregularidades relativas a integridade, confiabilidade, segurança, sigilo ou legitimidade das operações e serviços prestados relacionados a administradora de consórcio;1;1;0;2;
2023;1º;47458153;YAMAHA ADMINISTRADORA DE CONSÓRCIO LTDA.;Irregularidades relativas a telemarketing, SMS ou WhatsApp com oferta de Consórcio;0;0;1;1;
2023;1º;47458153;YAMAHA ADMINISTRADORA DE CONSÓRCIO LTDA.;Não fornecimento, remessa ou divulgação de documentos por parte de administradora de consórcio;0;2;0;2;
2023;1º;47458153;YAMAHA ADMINISTRADORA DE CONSÓRCIO LTDA.;Oferta ou prestação de informação a respeito de produtos e serviços de forma inadequada por administradora de consórcio;1;3;0;4;
2023;1º;47458153;YAMAHA ADMINISTRADORA DE CONSÓRCIO LTDA.;Recusa de produtos ou serviços - Consórcio;0;0;1;1;
2023;1º;23367634;ZEMA ADMINISTRADORA DE CONSÓRCIO LTDA;Descumprimento de cláusulas referentes à devolução de valores;0;1;0;1;
2023;1º;23367634;ZEMA ADMINISTRADORA DE CONSÓRCIO LTDA;Falta de transparência na redação de documentos por parte de administradora de consórcio;1;0;0;1;
2023;1º;23367634;ZEMA ADMINISTRADORA DE CONSÓRCIO LTDA;Insatisfação com a resposta fornecida pela administradora de consórcio relativa à demanda registrada contra ela;0;1;0;1;
2023;1º;23367634;ZEMA ADMINISTRADORA DE CONSÓRCIO LTDA;Irregularidades relativas a integridade, confiabilidade, segurança, sigilo ou legitimidade das operações e serviços prestados relacionados a administradora de consórcio;1;1;0;2;
2023;1º;23367634;ZEMA ADMINISTRADORA DE CONSÓRCIO LTDA;Oferta ou prestação de informação a respeito de produtos e serviços de forma inadequada por administradora de consórcio;12;10;0;22;
2023;1º;23367634;ZEMA ADMINISTRADORA DE CONSÓRCIO LTDA;Renegociação de dívida - Consórcio;0;0;2;2;
