Ano;Semestre;CNPJ AC;Administradora de consórcio;Irregularidade;Quantidade de reclamações reguladas procedentes;Quantidade de reclamações reguladas - outras;Quantidade de reclamações não reguladas;Quantidade total de reclamações;
2022;2º;84911098;ADEMICON ADMINISTRADORA DE CONSÓRCIOS S.A.;Descumprimento de cláusulas referentes à devolução de valores;0;2;0;2;
2022;2º;84911098;ADEMICON ADMINISTRADORA DE CONSÓRCIOS S.A.;Descumprimento de obrigações previstas em contratos;0;1;0;1;
2022;2º;84911098;ADEMICON ADMINISTRADORA DE CONSÓRCIOS S.A.;Insatisfação com a resposta fornecida pela administradora de consórcio relativa à demanda registrada contra ela;1;0;0;1;
2022;2º;84911098;ADEMICON ADMINISTRADORA DE CONSÓRCIOS S.A.;Irregularidades relacionadas à liberação do crédito;0;1;0;1;
2022;2º;84911098;ADEMICON ADMINISTRADORA DE CONSÓRCIOS S.A.;Irregularidades relativas a integridade, confiabilidade, segurança, sigilo ou legitimidade das operações e serviços prestados relacionados a administradora de consórcio;1;2;0;3;
2022;2º;84911098;ADEMICON ADMINISTRADORA DE CONSÓRCIOS S.A.;Oferta ou prestação de informação a respeito de produtos e serviços de forma inadequada por administradora de consórcio;0;1;0;1;
2022;2º;84911098;ADEMICON ADMINISTRADORA DE CONSÓRCIOS S.A.;Reclamações relacionadas a assuntos diversos;0;0;1;1;
2022;2º;06044551;ADMINISTRADORA DE CONSORCIO NACIONAL GAZIN LTDA;Descumprimento de cláusulas referentes à devolução de valores;0;1;0;1;
2022;2º;06044551;ADMINISTRADORA DE CONSORCIO NACIONAL GAZIN LTDA;Irregularidades relativas a integridade, confiabilidade, segurança, sigilo ou legitimidade das operações e serviços prestados relacionados a administradora de consórcio;0;1;0;1;
2022;2º;45441789;ADMINISTRADORA DE CONSORCIO NACIONAL HONDA LTDA;Ausência de transparência nas relações contratuais;0;0;3;3;
2022;2º;45441789;ADMINISTRADORA DE CONSORCIO NACIONAL HONDA LTDA;Descumprimento de cláusulas referentes à devolução de valores;1;9;0;10;
2022;2º;45441789;ADMINISTRADORA DE CONSORCIO NACIONAL HONDA LTDA;Descumprimento de obrigações previstas em contratos;1;11;0;12;
2022;2º;45441789;ADMINISTRADORA DE CONSORCIO NACIONAL HONDA LTDA;Descumprimento de prazo de resposta a demanda;0;1;0;1;
2022;2º;45441789;ADMINISTRADORA DE CONSORCIO NACIONAL HONDA LTDA;Insatisfação com a resposta fornecida pela administradora de consórcio relativa à demanda registrada contra ela;1;9;0;10;
2022;2º;45441789;ADMINISTRADORA DE CONSORCIO NACIONAL HONDA LTDA;Insatisfação por parte do cliente com o atendimento prestado pela administradora de consórcio;0;0;2;2;
2022;2º;45441789;ADMINISTRADORA DE CONSORCIO NACIONAL HONDA LTDA;Irregularidades relacionadas a informações e liquidação de valores a receber no sistema SVR do BCB por parte de consórcios;61;107;0;168;
2022;2º;45441789;ADMINISTRADORA DE CONSORCIO NACIONAL HONDA LTDA;Irregularidades relacionadas à liberação do crédito;0;23;0;23;
2022;2º;45441789;ADMINISTRADORA DE CONSORCIO NACIONAL HONDA LTDA;Irregularidades relacionadas às condições para contemplação por lance ou sorteio;0;5;0;5;
2022;2º;45441789;ADMINISTRADORA DE CONSORCIO NACIONAL HONDA LTDA;Irregularidades relativas a integridade, confiabilidade, segurança, sigilo ou legitimidade das operações e serviços prestados relacionados a administradora de consórcio;32;9;0;41;
2022;2º;45441789;ADMINISTRADORA DE CONSORCIO NACIONAL HONDA LTDA;Não fornecimento, remessa ou divulgação de documentos por parte de administradora de consórcio;1;5;0;6;
2022;2º;45441789;ADMINISTRADORA DE CONSORCIO NACIONAL HONDA LTDA;Oferta ou prestação de informação a respeito de produtos e serviços de forma inadequada por administradora de consórcio;6;3;0;9;
2022;2º;45441789;ADMINISTRADORA DE CONSORCIO NACIONAL HONDA LTDA;Reclamações relacionadas a assuntos diversos;0;0;17;17;
2022;2º;07808907;ADMINISTRADORA DE CONSORCIOS SICREDI LTDA;Descumprimento de cláusulas referentes à devolução de valores;0;1;0;1;
2022;2º;07808907;ADMINISTRADORA DE CONSORCIOS SICREDI LTDA;Descumprimento de obrigações previstas em contratos;0;2;0;2;
2022;2º;07808907;ADMINISTRADORA DE CONSORCIOS SICREDI LTDA;Irregularidades relacionadas a informações e liquidação de valores a receber no sistema SVR do BCB por parte de consórcios;0;2;0;2;
2022;2º;07808907;ADMINISTRADORA DE CONSORCIOS SICREDI LTDA;Irregularidades relacionadas à liberação do crédito;0;1;0;1;
2022;2º;07808907;ADMINISTRADORA DE CONSORCIOS SICREDI LTDA;Irregularidades relativas a integridade, confiabilidade, segurança, sigilo ou legitimidade das operações e serviços prestados relacionados a administradora de consórcio;4;0;0;4;
2022;2º;07808907;ADMINISTRADORA DE CONSORCIOS SICREDI LTDA;Oferta ou prestação de informação a respeito de produtos e serviços de forma inadequada por administradora de consórcio;0;2;0;2;
2022;2º;03765340;ADMINISTRADORA DE CONSÓRCIO NACIONAL VALOR S.A.;Descumprimento de cláusulas referentes à devolução de valores;0;1;0;1;
2022;2º;03765340;ADMINISTRADORA DE CONSÓRCIO NACIONAL VALOR S.A.;Irregularidades relacionadas a informações e liquidação de valores a receber no sistema SVR do BCB por parte de consórcios;0;1;0;1;
2022;2º;03765340;ADMINISTRADORA DE CONSÓRCIO NACIONAL VALOR S.A.;Oferta ou prestação de informação a respeito de produtos e serviços de forma inadequada por administradora de consórcio;1;1;0;2;
2022;2º;59999300;ADMINISTRADORA DE CONSÓRCIO NACIONAL VIME LTDA.;Descumprimento de obrigações previstas em contratos;0;3;0;3;
2022;2º;73230674;ADMINISTRADORA DE CONSÓRCIO RCI BRASIL LTDA;Descumprimento de cláusulas referentes à devolução de valores;0;3;0;3;
2022;2º;73230674;ADMINISTRADORA DE CONSÓRCIO RCI BRASIL LTDA;Descumprimento de obrigações previstas em contratos;0;4;0;4;
2022;2º;73230674;ADMINISTRADORA DE CONSÓRCIO RCI BRASIL LTDA;Irregularidades relacionadas a informações e liquidação de valores a receber no sistema SVR do BCB por parte de consórcios;0;1;0;1;
2022;2º;73230674;ADMINISTRADORA DE CONSÓRCIO RCI BRASIL LTDA;Irregularidades relacionadas à liberação do crédito;0;4;0;4;
2022;2º;73230674;ADMINISTRADORA DE CONSÓRCIO RCI BRASIL LTDA;Irregularidades relativas a integridade, confiabilidade, segurança, sigilo ou legitimidade das operações e serviços prestados relacionados a administradora de consórcio;0;4;0;4;
2022;2º;73230674;ADMINISTRADORA DE CONSÓRCIO RCI BRASIL LTDA;Oferta ou prestação de informação a respeito de produtos e serviços de forma inadequada por administradora de consórcio;1;0;0;1;
2022;2º;91341925;ADMINISTRADORA DE CONSÓRCIO SPENGLER LTDA.;Descumprimento de cláusulas referentes à devolução de valores;0;1;0;1;
2022;2º;12228808;ADMINISTRADORA DE CONSÓRCIO UNICOOB LTDA;Irregularidades relacionadas à liberação do crédito;0;2;0;2;
2022;2º;12228808;ADMINISTRADORA DE CONSÓRCIO UNICOOB LTDA;Irregularidades relativas a integridade, confiabilidade, segurança, sigilo ou legitimidade das operações e serviços prestados relacionados a administradora de consórcio;2;0;0;2;
2022;2º;12228808;ADMINISTRADORA DE CONSÓRCIO UNICOOB LTDA;Oferta ou prestação de informação a respeito de produtos e serviços de forma inadequada por administradora de consórcio;1;0;0;1;
2022;2º;03828278;ADMINISTRADORA DE CONSÓRCIOS BECKER LTDA.;Irregularidades relativas a integridade, confiabilidade, segurança, sigilo ou legitimidade das operações e serviços prestados relacionados a administradora de consórcio;1;0;0;1;
2022;2º;94187879;AGIBANK ADMINISTRADORA DE CONSÓRCIOS LTDA;Descumprimento de cláusulas referentes à devolução de valores;0;3;0;3;
2022;2º;94187879;AGIBANK ADMINISTRADORA DE CONSÓRCIOS LTDA;Insatisfação com a resposta fornecida pela administradora de consórcio relativa à demanda registrada contra ela;0;1;0;1;
2022;2º;94187879;AGIBANK ADMINISTRADORA DE CONSÓRCIOS LTDA;Insatisfação por parte do cliente com o atendimento prestado pela administradora de consórcio;0;0;1;1;
2022;2º;94187879;AGIBANK ADMINISTRADORA DE CONSÓRCIOS LTDA;Irregularidades relacionadas a informações e liquidação de valores a receber no sistema SVR do BCB por parte de consórcios;3;1;0;4;
2022;2º;94187879;AGIBANK ADMINISTRADORA DE CONSÓRCIOS LTDA;Irregularidades relativas a integridade, confiabilidade, segurança, sigilo ou legitimidade das operações e serviços prestados relacionados a administradora de consórcio;7;0;0;7;
2022;2º;94187879;AGIBANK ADMINISTRADORA DE CONSÓRCIOS LTDA;Não fornecimento, remessa ou divulgação de documentos por parte de administradora de consórcio;1;0;0;1;
2022;2º;94187879;AGIBANK ADMINISTRADORA DE CONSÓRCIOS LTDA;Oferta ou prestação de informação a respeito de produtos e serviços de forma inadequada por administradora de consórcio;1;0;0;1;
2022;2º;90982679;ALPHA ADMINISTRADORA DE CONSÓRCIO LTDA.;Insatisfação por parte do cliente com o atendimento prestado pela administradora de consórcio;0;0;1;1;
2022;2º;60375243;ANCORA ADMINISTRADORA DE CONSORCIOS S.A.;Irregularidades relacionadas à liberação do crédito;0;1;0;1;
2022;2º;60375243;ANCORA ADMINISTRADORA DE CONSORCIOS S.A.;Irregularidades relativas a integridade, confiabilidade, segurança, sigilo ou legitimidade das operações e serviços prestados relacionados a administradora de consórcio;0;1;0;1;
2022;2º;60375243;ANCORA ADMINISTRADORA DE CONSORCIOS S.A.;Oferta ou prestação de informação a respeito de produtos e serviços de forma inadequada por administradora de consórcio;3;1;0;4;
2022;2º;60375243;ANCORA ADMINISTRADORA DE CONSORCIOS S.A.;Reclamações relacionadas a assuntos diversos;0;0;1;1;
2022;2º;03832228;APEC - ADMINISTRADORA DE CONSORCIOS S/A;Irregularidades relacionadas às condições para contemplação por lance ou sorteio;0;1;0;1;
2022;2º;71045363;BAMAQ ADMINISTRADORA DE CONSÓRCIOS LTDA;Descumprimento de cláusulas referentes à devolução de valores;0;1;0;1;
2022;2º;71045363;BAMAQ ADMINISTRADORA DE CONSÓRCIOS LTDA;Irregularidades relativas a integridade, confiabilidade, segurança, sigilo ou legitimidade das operações e serviços prestados relacionados a administradora de consórcio;2;1;0;3;
2022;2º;71045363;BAMAQ ADMINISTRADORA DE CONSÓRCIOS LTDA;Reclamações relacionadas a assuntos diversos;0;0;1;1;
2022;2º;02010478;BANCORBRÁS ADMINISTRADORA DE CONSÓRCIOS S.A.;Descumprimento de cláusulas referentes à devolução de valores;0;1;0;1;
2022;2º;02010478;BANCORBRÁS ADMINISTRADORA DE CONSÓRCIOS S.A.;Irregularidades relacionadas a informações e liquidação de valores a receber no sistema SVR do BCB por parte de consórcios;6;5;0;11;
2022;2º;02010478;BANCORBRÁS ADMINISTRADORA DE CONSÓRCIOS S.A.;Irregularidades relacionadas à liberação do crédito;0;1;0;1;
2022;2º;02010478;BANCORBRÁS ADMINISTRADORA DE CONSÓRCIOS S.A.;Irregularidades relacionadas às condições para contemplação por lance ou sorteio;0;2;0;2;
2022;2º;02010478;BANCORBRÁS ADMINISTRADORA DE CONSÓRCIOS S.A.;Irregularidades relativas a integridade, confiabilidade, segurança, sigilo ou legitimidade das operações e serviços prestados relacionados a administradora de consórcio;1;2;0;3;
2022;2º;02010478;BANCORBRÁS ADMINISTRADORA DE CONSÓRCIOS S.A.;Não fornecimento, remessa ou divulgação de documentos por parte de administradora de consórcio;0;1;0;1;
2022;2º;02010478;BANCORBRÁS ADMINISTRADORA DE CONSÓRCIOS S.A.;Oferta ou prestação de informação a respeito de produtos e serviços de forma inadequada por administradora de consórcio;0;1;0;1;
2022;2º;92692979;BANRISUL S.A. - ADMINISTRADORA DE CONSÓRCIOS;Descumprimento de cláusulas referentes à devolução de valores;0;1;0;1;
2022;2º;92692979;BANRISUL S.A. - ADMINISTRADORA DE CONSÓRCIOS;Irregularidades relacionadas a informações e liquidação de valores a receber no sistema SVR do BCB por parte de consórcios;2;3;0;5;
2022;2º;92692979;BANRISUL S.A. - ADMINISTRADORA DE CONSÓRCIOS;Irregularidades relacionadas à liberação do crédito;0;2;0;2;
2022;2º;92692979;BANRISUL S.A. - ADMINISTRADORA DE CONSÓRCIOS;Irregularidades relativas a integridade, confiabilidade, segurança, sigilo ou legitimidade das operações e serviços prestados relacionados a administradora de consórcio;1;0;0;1;
2022;2º;06043050;BB ADMINISTRADORA DE CONSORCIOS S.A.;Ausência de transparência nas relações contratuais;0;0;6;6;
2022;2º;06043050;BB ADMINISTRADORA DE CONSORCIOS S.A.;Cancelamento de contrato a pedido do cliente não atendido por administradora de consórcio;0;1;0;1;
2022;2º;06043050;BB ADMINISTRADORA DE CONSORCIOS S.A.;Cobrança irregular de tarifa pela emissão de boletos, carnês e assemelhados;0;1;0;1;
2022;2º;06043050;BB ADMINISTRADORA DE CONSORCIOS S.A.;Descumprimento de cláusulas referentes à devolução de valores;2;7;0;9;
2022;2º;06043050;BB ADMINISTRADORA DE CONSORCIOS S.A.;Descumprimento de obrigações previstas em contratos;7;15;0;22;
2022;2º;06043050;BB ADMINISTRADORA DE CONSORCIOS S.A.;Descumprimento de prazo de resposta a demanda;0;2;0;2;
2022;2º;06043050;BB ADMINISTRADORA DE CONSORCIOS S.A.;Insatisfação com a resposta fornecida pela administradora de consórcio relativa à demanda registrada contra ela;3;13;0;16;
2022;2º;06043050;BB ADMINISTRADORA DE CONSORCIOS S.A.;Insatisfação por parte do cliente com o atendimento prestado pela administradora de consórcio;0;0;7;7;
2022;2º;06043050;BB ADMINISTRADORA DE CONSORCIOS S.A.;Irregularidades relacionadas a informações e liquidação de valores a receber no sistema SVR do BCB por parte de consórcios;7;12;0;19;
2022;2º;06043050;BB ADMINISTRADORA DE CONSORCIOS S.A.;Irregularidades relacionadas à liberação do crédito;11;39;0;50;
2022;2º;06043050;BB ADMINISTRADORA DE CONSORCIOS S.A.;Irregularidades relacionadas às condições para contemplação por lance ou sorteio;1;9;0;10;
2022;2º;06043050;BB ADMINISTRADORA DE CONSORCIOS S.A.;Irregularidades relativas a integridade, confiabilidade, segurança, sigilo ou legitimidade das operações e serviços prestados relacionados a administradora de consórcio;82;20;0;102;
2022;2º;06043050;BB ADMINISTRADORA DE CONSORCIOS S.A.;Não fornecimento, remessa ou divulgação de documentos por parte de administradora de consórcio;4;5;0;9;
2022;2º;06043050;BB ADMINISTRADORA DE CONSORCIOS S.A.;Oferta ou prestação de informação a respeito de produtos e serviços de forma inadequada por administradora de consórcio;11;10;0;21;
2022;2º;06043050;BB ADMINISTRADORA DE CONSORCIOS S.A.;Outras irregularidades;1;0;0;1;
2022;2º;06043050;BB ADMINISTRADORA DE CONSORCIOS S.A.;Reclamações relacionadas a assuntos diversos;0;0;15;15;
2022;2º;36770683;BBC ADMINISTRADORA DE CONSÓRCIOS LTDA;Irregularidades relacionadas a informações e liquidação de valores a receber no sistema SVR do BCB por parte de consórcios;0;1;0;1;
2022;2º;14723388;BR CONSÓRCIOS ADMINISTRADORA DE CONSÓRCIOS LTDA;Descumprimento de cláusulas referentes à devolução de valores;0;4;0;4;
2022;2º;14723388;BR CONSÓRCIOS ADMINISTRADORA DE CONSÓRCIOS LTDA;Descumprimento de obrigações previstas em contratos;0;1;0;1;
2022;2º;14723388;BR CONSÓRCIOS ADMINISTRADORA DE CONSÓRCIOS LTDA;Insatisfação com a resposta fornecida pela administradora de consórcio relativa à demanda registrada contra ela;0;4;0;4;
2022;2º;14723388;BR CONSÓRCIOS ADMINISTRADORA DE CONSÓRCIOS LTDA;Irregularidades relacionadas a informações e liquidação de valores a receber no sistema SVR do BCB por parte de consórcios;1;2;0;3;
2022;2º;14723388;BR CONSÓRCIOS ADMINISTRADORA DE CONSÓRCIOS LTDA;Irregularidades relacionadas à liberação do crédito;0;1;0;1;
2022;2º;14723388;BR CONSÓRCIOS ADMINISTRADORA DE CONSÓRCIOS LTDA;Irregularidades relacionadas às condições para contemplação por lance ou sorteio;0;1;0;1;
2022;2º;14723388;BR CONSÓRCIOS ADMINISTRADORA DE CONSÓRCIOS LTDA;Irregularidades relativas a integridade, confiabilidade, segurança, sigilo ou legitimidade das operações e serviços prestados relacionados a administradora de consórcio;0;1;0;1;
2022;2º;14723388;BR CONSÓRCIOS ADMINISTRADORA DE CONSÓRCIOS LTDA;Oferta ou prestação de informação a respeito de produtos e serviços de forma inadequada por administradora de consórcio;0;1;0;1;
2022;2º;14723388;BR CONSÓRCIOS ADMINISTRADORA DE CONSÓRCIOS LTDA;Reclamações relacionadas a assuntos diversos;0;0;1;1;
2022;2º;52568821;BRADESCO ADMINISTRADORA DE CONSÓRCIOS LTDA.;Ausência de transparência nas relações contratuais;0;0;3;3;
2022;2º;52568821;BRADESCO ADMINISTRADORA DE CONSÓRCIOS LTDA.;Cancelamento de contrato a pedido do cliente não atendido por administradora de consórcio;2;0;0;2;
2022;2º;52568821;BRADESCO ADMINISTRADORA DE CONSÓRCIOS LTDA.;Descumprimento de cláusulas referentes à devolução de valores;8;85;0;93;
2022;2º;52568821;BRADESCO ADMINISTRADORA DE CONSÓRCIOS LTDA.;Descumprimento de obrigações previstas em contratos;8;33;0;41;
2022;2º;52568821;BRADESCO ADMINISTRADORA DE CONSÓRCIOS LTDA.;Descumprimento de prazo de resposta a demanda;1;4;0;5;
2022;2º;52568821;BRADESCO ADMINISTRADORA DE CONSÓRCIOS LTDA.;Falta de transparência na redação de documentos por parte de administradora de consórcio;0;1;0;1;
2022;2º;52568821;BRADESCO ADMINISTRADORA DE CONSÓRCIOS LTDA.;Insatisfação com a resposta fornecida pela administradora de consórcio relativa à demanda registrada contra ela;10;38;0;48;
2022;2º;52568821;BRADESCO ADMINISTRADORA DE CONSÓRCIOS LTDA.;Insatisfação por parte do cliente com o atendimento prestado pela administradora de consórcio;0;0;13;13;
2022;2º;52568821;BRADESCO ADMINISTRADORA DE CONSÓRCIOS LTDA.;Irregularidades relacionadas a informações e liquidação de valores a receber no sistema SVR do BCB por parte de consórcios;180;123;0;303;
2022;2º;52568821;BRADESCO ADMINISTRADORA DE CONSÓRCIOS LTDA.;Irregularidades relacionadas à liberação do crédito;6;94;0;100;
2022;2º;52568821;BRADESCO ADMINISTRADORA DE CONSÓRCIOS LTDA.;Irregularidades relacionadas às condições para contemplação por lance ou sorteio;1;9;0;10;
2022;2º;52568821;BRADESCO ADMINISTRADORA DE CONSÓRCIOS LTDA.;Irregularidades relativas a integridade, confiabilidade, segurança, sigilo ou legitimidade das operações e serviços prestados relacionados a administradora de consórcio;178;89;0;267;
2022;2º;52568821;BRADESCO ADMINISTRADORA DE CONSÓRCIOS LTDA.;Não fornecimento, remessa ou divulgação de documentos por parte de administradora de consórcio;7;12;0;19;
2022;2º;52568821;BRADESCO ADMINISTRADORA DE CONSÓRCIOS LTDA.;Oferta ou prestação de informação a respeito de produtos e serviços de forma inadequada por administradora de consórcio;14;8;0;22;
2022;2º;52568821;BRADESCO ADMINISTRADORA DE CONSÓRCIOS LTDA.;Outras irregularidades;0;3;0;3;
2022;2º;52568821;BRADESCO ADMINISTRADORA DE CONSÓRCIOS LTDA.;Outras irregularidades relacionadas à Ouvidoria;0;2;0;2;
2022;2º;52568821;BRADESCO ADMINISTRADORA DE CONSÓRCIOS LTDA.;Reclamações relacionadas a assuntos diversos;0;0;32;32;
2022;2º;73235962;BREITKOPF ADMINISTRADORA DE CONSÓRCIO LTDA.;Irregularidades relacionadas a informações e liquidação de valores a receber no sistema SVR do BCB por parte de consórcios;0;1;0;1;
2022;2º;73235962;BREITKOPF ADMINISTRADORA DE CONSÓRCIO LTDA.;Oferta ou prestação de informação a respeito de produtos e serviços de forma inadequada por administradora de consórcio;0;1;0;1;
2022;2º;45713971;BRQUALY ADMINISTRADORA DE CONSÓRCIOS LTDA.;Descumprimento de cláusulas referentes à devolução de valores;0;1;0;1;
2022;2º;45713971;BRQUALY ADMINISTRADORA DE CONSÓRCIOS LTDA.;Descumprimento de obrigações previstas em contratos;0;1;0;1;
2022;2º;45713971;BRQUALY ADMINISTRADORA DE CONSÓRCIOS LTDA.;Irregularidades relacionadas à liberação do crédito;0;1;0;1;
2022;2º;45713971;BRQUALY ADMINISTRADORA DE CONSÓRCIOS LTDA.;Irregularidades relativas a integridade, confiabilidade, segurança, sigilo ou legitimidade das operações e serviços prestados relacionados a administradora de consórcio;0;1;0;1;
2022;2º;45713971;BRQUALY ADMINISTRADORA DE CONSÓRCIOS LTDA.;Oferta ou prestação de informação a respeito de produtos e serviços de forma inadequada por administradora de consórcio;1;0;0;1;
2022;2º;68318773;CANOPUS ADMINISTRADORA DE CONSORCIOS S/A;Descumprimento de cláusulas referentes à devolução de valores;0;4;0;4;
2022;2º;68318773;CANOPUS ADMINISTRADORA DE CONSORCIOS S/A;Irregularidades relacionadas às condições para contemplação por lance ou sorteio;0;1;0;1;
2022;2º;68318773;CANOPUS ADMINISTRADORA DE CONSORCIOS S/A;Irregularidades relativas a integridade, confiabilidade, segurança, sigilo ou legitimidade das operações e serviços prestados relacionados a administradora de consórcio;0;1;0;1;
2022;2º;68318773;CANOPUS ADMINISTRADORA DE CONSORCIOS S/A;Não fornecimento, remessa ou divulgação de documentos por parte de administradora de consórcio;0;1;0;1;
2022;2º;68318773;CANOPUS ADMINISTRADORA DE CONSORCIOS S/A;Oferta ou prestação de informação a respeito de produtos e serviços de forma inadequada por administradora de consórcio;1;2;0;3;
2022;2º;68318773;CANOPUS ADMINISTRADORA DE CONSORCIOS S/A;Reclamações relacionadas a assuntos diversos;0;0;2;2;
2022;2º;00266031;CICAL ADMINISTRADORA DE CONSÓRCIOS LTDA;Irregularidades relacionadas a informações e liquidação de valores a receber no sistema SVR do BCB por parte de consórcios;1;0;0;1;
2022;2º;59129403;CNF - ADMINISTRADORA DE CONSÓRCIOS NACIONAL LTDA.;Irregularidades relacionadas a informações e liquidação de valores a receber no sistema SVR do BCB por parte de consórcios;1;2;0;3;
2022;2º;59129403;CNF - ADMINISTRADORA DE CONSÓRCIOS NACIONAL LTDA.;Irregularidades relacionadas à liberação do crédito;0;2;0;2;
2022;2º;59129403;CNF - ADMINISTRADORA DE CONSÓRCIOS NACIONAL LTDA.;Irregularidades relativas a integridade, confiabilidade, segurança, sigilo ou legitimidade das operações e serviços prestados relacionados a administradora de consórcio;1;2;0;3;
2022;2º;62798475;CNK ADMINISTRADORA DE CONSÓRCIO LTDA.;Descumprimento de cláusulas referentes à devolução de valores;0;7;0;7;
2022;2º;62798475;CNK ADMINISTRADORA DE CONSÓRCIO LTDA.;Insatisfação com a resposta fornecida pela administradora de consórcio relativa à demanda registrada contra ela;0;2;0;2;
2022;2º;62798475;CNK ADMINISTRADORA DE CONSÓRCIO LTDA.;Irregularidades relacionadas a informações e liquidação de valores a receber no sistema SVR do BCB por parte de consórcios;0;2;0;2;
2022;2º;62798475;CNK ADMINISTRADORA DE CONSÓRCIO LTDA.;Irregularidades relacionadas à liberação do crédito;0;1;0;1;
2022;2º;62798475;CNK ADMINISTRADORA DE CONSÓRCIO LTDA.;Irregularidades relacionadas às condições para contemplação por lance ou sorteio;0;1;0;1;
2022;2º;62798475;CNK ADMINISTRADORA DE CONSÓRCIO LTDA.;Irregularidades relativas a integridade, confiabilidade, segurança, sigilo ou legitimidade das operações e serviços prestados relacionados a administradora de consórcio;1;3;0;4;
2022;2º;62798475;CNK ADMINISTRADORA DE CONSÓRCIO LTDA.;Oferta ou prestação de informação a respeito de produtos e serviços de forma inadequada por administradora de consórcio;23;22;0;45;
2022;2º;05349595;CNP CONSÓRCIO S.A. ADMINISTRADORA DE CONSÓRCIOS;Ausência de transparência nas relações contratuais;0;0;2;2;
2022;2º;05349595;CNP CONSÓRCIO S.A. ADMINISTRADORA DE CONSÓRCIOS;Descumprimento de cláusulas referentes à devolução de valores;4;14;0;18;
2022;2º;05349595;CNP CONSÓRCIO S.A. ADMINISTRADORA DE CONSÓRCIOS;Descumprimento de obrigações previstas em contratos;1;7;0;8;
2022;2º;05349595;CNP CONSÓRCIO S.A. ADMINISTRADORA DE CONSÓRCIOS;Descumprimento de prazo de resposta a demanda;0;4;0;4;
2022;2º;05349595;CNP CONSÓRCIO S.A. ADMINISTRADORA DE CONSÓRCIOS;Insatisfação com a resposta fornecida pela administradora de consórcio relativa à demanda registrada contra ela;2;9;0;11;
2022;2º;05349595;CNP CONSÓRCIO S.A. ADMINISTRADORA DE CONSÓRCIOS;Insatisfação por parte do cliente com o atendimento prestado pela administradora de consórcio;0;0;9;9;
2022;2º;05349595;CNP CONSÓRCIO S.A. ADMINISTRADORA DE CONSÓRCIOS;Irregularidades relacionadas a informações e liquidação de valores a receber no sistema SVR do BCB por parte de consórcios;44;55;0;99;
2022;2º;05349595;CNP CONSÓRCIO S.A. ADMINISTRADORA DE CONSÓRCIOS;Irregularidades relacionadas à liberação do crédito;6;38;0;44;
2022;2º;05349595;CNP CONSÓRCIO S.A. ADMINISTRADORA DE CONSÓRCIOS;Irregularidades relacionadas às condições para contemplação por lance ou sorteio;0;2;0;2;
2022;2º;05349595;CNP CONSÓRCIO S.A. ADMINISTRADORA DE CONSÓRCIOS;Irregularidades relativas a integridade, confiabilidade, segurança, sigilo ou legitimidade das operações e serviços prestados relacionados a administradora de consórcio;106;39;0;145;
2022;2º;05349595;CNP CONSÓRCIO S.A. ADMINISTRADORA DE CONSÓRCIOS;Não fornecimento, remessa ou divulgação de documentos por parte de administradora de consórcio;6;3;0;9;
2022;2º;05349595;CNP CONSÓRCIO S.A. ADMINISTRADORA DE CONSÓRCIOS;Oferta ou prestação de informação a respeito de produtos e serviços de forma inadequada por administradora de consórcio;18;10;0;28;
2022;2º;05349595;CNP CONSÓRCIO S.A. ADMINISTRADORA DE CONSÓRCIOS;Reclamações relacionadas a assuntos diversos;0;0;17;17;
2022;2º;27268770;COIMEX ADMINISTRADORA DE CONSÓRCIOS S.A.;Descumprimento de obrigações previstas em contratos;0;2;0;2;
2022;2º;27268770;COIMEX ADMINISTRADORA DE CONSÓRCIOS S.A.;Insatisfação com a resposta fornecida pela administradora de consórcio relativa à demanda registrada contra ela;1;2;0;3;
2022;2º;27268770;COIMEX ADMINISTRADORA DE CONSÓRCIOS S.A.;Insatisfação por parte do cliente com o atendimento prestado pela administradora de consórcio;0;0;1;1;
2022;2º;27268770;COIMEX ADMINISTRADORA DE CONSÓRCIOS S.A.;Irregularidades relacionadas a informações e liquidação de valores a receber no sistema SVR do BCB por parte de consórcios;0;1;0;1;
2022;2º;27268770;COIMEX ADMINISTRADORA DE CONSÓRCIOS S.A.;Irregularidades relacionadas à liberação do crédito;0;3;0;3;
2022;2º;27268770;COIMEX ADMINISTRADORA DE CONSÓRCIOS S.A.;Irregularidades relacionadas às condições para contemplação por lance ou sorteio;0;2;0;2;
2022;2º;27268770;COIMEX ADMINISTRADORA DE CONSÓRCIOS S.A.;Irregularidades relativas a integridade, confiabilidade, segurança, sigilo ou legitimidade das operações e serviços prestados relacionados a administradora de consórcio;3;3;0;6;
2022;2º;27268770;COIMEX ADMINISTRADORA DE CONSÓRCIOS S.A.;Oferta ou prestação de informação a respeito de produtos e serviços de forma inadequada por administradora de consórcio;3;1;0;4;
2022;2º;27268770;COIMEX ADMINISTRADORA DE CONSÓRCIOS S.A.;Reclamações relacionadas a assuntos diversos;0;0;1;1;
2022;2º;44474674;COMAUTO ADMINISTRADORA DE CONSORCIO LTDA;Irregularidades relacionadas a informações e liquidação de valores a receber no sistema SVR do BCB por parte de consórcios;3;1;0;4;
2022;2º;92459213;CONESUL ADMINISTRADORA DE CONSÓRCIOS LTDA.;Irregularidades relacionadas a informações e liquidação de valores a receber no sistema SVR do BCB por parte de consórcios;0;2;0;2;
2022;2º;44196293;CONSHOP ADMINISTRADORA DE CONSORCIOS LTDA.;Descumprimento de cláusulas referentes à devolução de valores;1;0;0;1;
2022;2º;44196293;CONSHOP ADMINISTRADORA DE CONSORCIOS LTDA.;Descumprimento de obrigações previstas em contratos;1;0;0;1;
2022;2º;44196293;CONSHOP ADMINISTRADORA DE CONSORCIOS LTDA.;Descumprimento de prazo de resposta a demanda;1;0;0;1;
2022;2º;44196293;CONSHOP ADMINISTRADORA DE CONSORCIOS LTDA.;Insatisfação com a resposta fornecida pela administradora de consórcio relativa à demanda registrada contra ela;1;1;0;2;
2022;2º;44196293;CONSHOP ADMINISTRADORA DE CONSORCIOS LTDA.;Irregularidades relacionadas a informações e liquidação de valores a receber no sistema SVR do BCB por parte de consórcios;0;2;0;2;
2022;2º;44196293;CONSHOP ADMINISTRADORA DE CONSORCIOS LTDA.;Irregularidades relacionadas às condições para contemplação por lance ou sorteio;1;0;0;1;
2022;2º;44196293;CONSHOP ADMINISTRADORA DE CONSORCIOS LTDA.;Irregularidades relativas a integridade, confiabilidade, segurança, sigilo ou legitimidade das operações e serviços prestados relacionados a administradora de consórcio;5;0;0;5;
2022;2º;44196293;CONSHOP ADMINISTRADORA DE CONSORCIOS LTDA.;Não fornecimento, remessa ou divulgação de documentos por parte de administradora de consórcio;1;0;0;1;
2022;2º;47658539;CONSÓRCIO NACIONAL VOLKSWAGEN - ADMINISTRADORA DE CONSÓRCIO LTDA.;Descumprimento de cláusulas referentes à devolução de valores;0;10;0;10;
2022;2º;47658539;CONSÓRCIO NACIONAL VOLKSWAGEN - ADMINISTRADORA DE CONSÓRCIO LTDA.;Descumprimento de obrigações previstas em contratos;0;6;0;6;
2022;2º;47658539;CONSÓRCIO NACIONAL VOLKSWAGEN - ADMINISTRADORA DE CONSÓRCIO LTDA.;Descumprimento de prazo de resposta a demanda;0;1;0;1;
2022;2º;47658539;CONSÓRCIO NACIONAL VOLKSWAGEN - ADMINISTRADORA DE CONSÓRCIO LTDA.;Golpe;0;0;1;1;
2022;2º;47658539;CONSÓRCIO NACIONAL VOLKSWAGEN - ADMINISTRADORA DE CONSÓRCIO LTDA.;Insatisfação com a resposta fornecida pela administradora de consórcio relativa à demanda registrada contra ela;0;9;0;9;
2022;2º;47658539;CONSÓRCIO NACIONAL VOLKSWAGEN - ADMINISTRADORA DE CONSÓRCIO LTDA.;Insatisfação por parte do cliente com o atendimento prestado pela administradora de consórcio;0;0;2;2;
2022;2º;47658539;CONSÓRCIO NACIONAL VOLKSWAGEN - ADMINISTRADORA DE CONSÓRCIO LTDA.;Irregularidades relacionadas a informações e liquidação de valores a receber no sistema SVR do BCB por parte de consórcios;21;56;0;77;
2022;2º;47658539;CONSÓRCIO NACIONAL VOLKSWAGEN - ADMINISTRADORA DE CONSÓRCIO LTDA.;Irregularidades relacionadas à liberação do crédito;1;6;0;7;
2022;2º;47658539;CONSÓRCIO NACIONAL VOLKSWAGEN - ADMINISTRADORA DE CONSÓRCIO LTDA.;Irregularidades relativas a integridade, confiabilidade, segurança, sigilo ou legitimidade das operações e serviços prestados relacionados a administradora de consórcio;25;13;0;38;
2022;2º;47658539;CONSÓRCIO NACIONAL VOLKSWAGEN - ADMINISTRADORA DE CONSÓRCIO LTDA.;Não fornecimento, remessa ou divulgação de documentos por parte de administradora de consórcio;2;0;0;2;
2022;2º;47658539;CONSÓRCIO NACIONAL VOLKSWAGEN - ADMINISTRADORA DE CONSÓRCIO LTDA.;Oferta ou prestação de informação a respeito de produtos e serviços de forma inadequada por administradora de consórcio;2;1;0;3;
2022;2º;47658539;CONSÓRCIO NACIONAL VOLKSWAGEN - ADMINISTRADORA DE CONSÓRCIO LTDA.;Reclamações relacionadas a assuntos diversos;0;0;5;5;
2022;2º;58919903;CONVEF ADMINISTRADORA DE CONSÓRCIOS LTDA.;Cobrança irregular de tarifa pela emissão de boletos, carnês e assemelhados;0;1;0;1;
2022;2º;58919903;CONVEF ADMINISTRADORA DE CONSÓRCIOS LTDA.;Descumprimento de cláusulas referentes à devolução de valores;0;4;0;4;
2022;2º;58919903;CONVEF ADMINISTRADORA DE CONSÓRCIOS LTDA.;Descumprimento de obrigações previstas em contratos;4;1;0;5;
2022;2º;58919903;CONVEF ADMINISTRADORA DE CONSÓRCIOS LTDA.;Insatisfação com a resposta fornecida pela administradora de consórcio relativa à demanda registrada contra ela;0;1;0;1;
2022;2º;58919903;CONVEF ADMINISTRADORA DE CONSÓRCIOS LTDA.;Irregularidades relacionadas a informações e liquidação de valores a receber no sistema SVR do BCB por parte de consórcios;1;2;0;3;
2022;2º;58919903;CONVEF ADMINISTRADORA DE CONSÓRCIOS LTDA.;Irregularidades relacionadas à liberação do crédito;0;1;0;1;
2022;2º;58919903;CONVEF ADMINISTRADORA DE CONSÓRCIOS LTDA.;Não fornecimento, remessa ou divulgação de documentos por parte de administradora de consórcio;0;1;0;1;
2022;2º;58919903;CONVEF ADMINISTRADORA DE CONSÓRCIOS LTDA.;Oferta ou prestação de informação a respeito de produtos e serviços de forma inadequada por administradora de consórcio;1;1;0;2;
2022;2º;58919903;CONVEF ADMINISTRADORA DE CONSÓRCIOS LTDA.;Reclamações relacionadas a assuntos diversos;0;0;1;1;
2022;2º;61550836;COOPERATIVA MISTA ROMA;Ausência de transparência nas relações contratuais;0;0;1;1;
2022;2º;61550836;COOPERATIVA MISTA ROMA;Descumprimento de cláusulas referentes à devolução de valores;0;4;0;4;
2022;2º;61550836;COOPERATIVA MISTA ROMA;Descumprimento de prazo de resposta a demanda;0;1;0;1;
2022;2º;61550836;COOPERATIVA MISTA ROMA;Insatisfação com a resposta fornecida pela administradora de consórcio relativa à demanda registrada contra ela;0;6;0;6;
2022;2º;61550836;COOPERATIVA MISTA ROMA;Insatisfação por parte do cliente com o atendimento prestado pela administradora de consórcio;0;0;1;1;
2022;2º;61550836;COOPERATIVA MISTA ROMA;Irregularidades relacionadas à liberação do crédito;0;1;0;1;
2022;2º;61550836;COOPERATIVA MISTA ROMA;Irregularidades relacionadas às condições para contemplação por lance ou sorteio;0;4;0;4;
2022;2º;61550836;COOPERATIVA MISTA ROMA;Irregularidades relativas a integridade, confiabilidade, segurança, sigilo ou legitimidade das operações e serviços prestados relacionados a administradora de consórcio;0;1;0;1;
2022;2º;61550836;COOPERATIVA MISTA ROMA;Oferta ou prestação de informação a respeito de produtos e serviços de forma inadequada por administradora de consórcio;28;25;0;53;
2022;2º;61550836;COOPERATIVA MISTA ROMA;Outras irregularidades relacionadas à Ouvidoria;0;1;0;1;
2022;2º;05794450;DESTAQUE ADMINISTRADORA DE CONSORCIOS LTDA;Irregularidades relacionadas a informações e liquidação de valores a receber no sistema SVR do BCB por parte de consórcios;2;0;0;2;
2022;2º;59395061;DISAL ADMINISTRADORA DE CONSÓRCIOS LTDA;Descumprimento de cláusulas referentes à devolução de valores;1;24;0;25;
2022;2º;59395061;DISAL ADMINISTRADORA DE CONSÓRCIOS LTDA;Descumprimento de obrigações previstas em contratos;2;4;0;6;
2022;2º;59395061;DISAL ADMINISTRADORA DE CONSÓRCIOS LTDA;Descumprimento de prazo de resposta a demanda;2;1;0;3;
2022;2º;59395061;DISAL ADMINISTRADORA DE CONSÓRCIOS LTDA;Insatisfação com a resposta fornecida pela administradora de consórcio relativa à demanda registrada contra ela;4;2;0;6;
2022;2º;59395061;DISAL ADMINISTRADORA DE CONSÓRCIOS LTDA;Insatisfação por parte do cliente com o atendimento prestado pela administradora de consórcio;0;0;2;2;
2022;2º;59395061;DISAL ADMINISTRADORA DE CONSÓRCIOS LTDA;Irregularidades relacionadas a informações e liquidação de valores a receber no sistema SVR do BCB por parte de consórcios;12;22;0;34;
2022;2º;59395061;DISAL ADMINISTRADORA DE CONSÓRCIOS LTDA;Irregularidades relacionadas à liberação do crédito;1;12;0;13;
2022;2º;59395061;DISAL ADMINISTRADORA DE CONSÓRCIOS LTDA;Irregularidades relacionadas às condições para contemplação por lance ou sorteio;0;1;0;1;
2022;2º;59395061;DISAL ADMINISTRADORA DE CONSÓRCIOS LTDA;Irregularidades relativas a integridade, confiabilidade, segurança, sigilo ou legitimidade das operações e serviços prestados relacionados a administradora de consórcio;40;8;0;48;
2022;2º;59395061;DISAL ADMINISTRADORA DE CONSÓRCIOS LTDA;Não fornecimento, remessa ou divulgação de documentos por parte de administradora de consórcio;0;3;0;3;
2022;2º;59395061;DISAL ADMINISTRADORA DE CONSÓRCIOS LTDA;Oferta ou prestação de informação a respeito de produtos e serviços de forma inadequada por administradora de consórcio;9;4;0;13;
2022;2º;59395061;DISAL ADMINISTRADORA DE CONSÓRCIOS LTDA;Outras irregularidades;0;1;0;1;
2022;2º;59395061;DISAL ADMINISTRADORA DE CONSÓRCIOS LTDA;Reclamações relacionadas a assuntos diversos;0;0;8;8;
2022;2º;01659838;DISBRAVE ADMINISTRADORA DE CONSORCIOS LTDA.;Descumprimento de cláusulas referentes à devolução de valores;0;2;0;2;
2022;2º;01659838;DISBRAVE ADMINISTRADORA DE CONSORCIOS LTDA.;Descumprimento de obrigações previstas em contratos;0;2;0;2;
2022;2º;01659838;DISBRAVE ADMINISTRADORA DE CONSORCIOS LTDA.;Descumprimento de prazo de resposta a demanda;1;0;0;1;
2022;2º;01659838;DISBRAVE ADMINISTRADORA DE CONSORCIOS LTDA.;Irregularidades relacionadas a informações e liquidação de valores a receber no sistema SVR do BCB por parte de consórcios;0;1;0;1;
2022;2º;01659838;DISBRAVE ADMINISTRADORA DE CONSORCIOS LTDA.;Irregularidades relativas a integridade, confiabilidade, segurança, sigilo ou legitimidade das operações e serviços prestados relacionados a administradora de consórcio;1;0;0;1;
2022;2º;01659838;DISBRAVE ADMINISTRADORA DE CONSORCIOS LTDA.;Oferta ou prestação de informação a respeito de produtos e serviços de forma inadequada por administradora de consórcio;4;1;0;5;
2022;2º;08570707;ELDORADO ADMINISTRADORA DE CONSORCIO LTDA;Insatisfação com a resposta fornecida pela administradora de consórcio relativa à demanda registrada contra ela;0;1;0;1;
2022;2º;08570707;ELDORADO ADMINISTRADORA DE CONSORCIO LTDA;Irregularidades relativas a integridade, confiabilidade, segurança, sigilo ou legitimidade das operações e serviços prestados relacionados a administradora de consórcio;0;1;0;1;
2022;2º;58113812;EMBRACON ADMINISTRADORA DE CONSÓRCIO LTDA;Ausência de transparência nas relações contratuais;0;0;2;2;
2022;2º;58113812;EMBRACON ADMINISTRADORA DE CONSÓRCIO LTDA;Cancelamento de contrato a pedido do cliente não atendido por administradora de consórcio;0;1;0;1;
2022;2º;58113812;EMBRACON ADMINISTRADORA DE CONSÓRCIO LTDA;Descumprimento de cláusulas referentes à devolução de valores;0;23;0;23;
2022;2º;58113812;EMBRACON ADMINISTRADORA DE CONSÓRCIO LTDA;Descumprimento de obrigações previstas em contratos;1;9;0;10;
2022;2º;58113812;EMBRACON ADMINISTRADORA DE CONSÓRCIO LTDA;Insatisfação com a resposta fornecida pela administradora de consórcio relativa à demanda registrada contra ela;1;5;0;6;
2022;2º;58113812;EMBRACON ADMINISTRADORA DE CONSÓRCIO LTDA;Insatisfação por parte do cliente com o atendimento prestado pela administradora de consórcio;0;0;1;1;
2022;2º;58113812;EMBRACON ADMINISTRADORA DE CONSÓRCIO LTDA;Irregularidades relacionadas a informações e liquidação de valores a receber no sistema SVR do BCB por parte de consórcios;3;36;0;39;
2022;2º;58113812;EMBRACON ADMINISTRADORA DE CONSÓRCIO LTDA;Irregularidades relacionadas à liberação do crédito;0;21;0;21;
2022;2º;58113812;EMBRACON ADMINISTRADORA DE CONSÓRCIO LTDA;Irregularidades relacionadas às condições para contemplação por lance ou sorteio;0;5;0;5;
2022;2º;58113812;EMBRACON ADMINISTRADORA DE CONSÓRCIO LTDA;Irregularidades relativas a integridade, confiabilidade, segurança, sigilo ou legitimidade das operações e serviços prestados relacionados a administradora de consórcio;10;22;0;32;
2022;2º;58113812;EMBRACON ADMINISTRADORA DE CONSÓRCIO LTDA;Não fornecimento, remessa ou divulgação de documentos por parte de administradora de consórcio;1;1;0;2;
2022;2º;58113812;EMBRACON ADMINISTRADORA DE CONSÓRCIO LTDA;Oferta ou prestação de informação a respeito de produtos e serviços de forma inadequada por administradora de consórcio;24;15;0;39;
2022;2º;58113812;EMBRACON ADMINISTRADORA DE CONSÓRCIO LTDA;Outras irregularidades relacionadas à Ouvidoria;1;0;0;1;
2022;2º;58113812;EMBRACON ADMINISTRADORA DE CONSÓRCIO LTDA;Reclamações relacionadas a assuntos diversos;0;0;6;6;
2022;2º;91107581;FARROUPILHA ADMINISTRADORA DE CONSÓRCIOS LTDA.;Descumprimento de obrigações previstas em contratos;0;1;0;1;
2022;2º;91107581;FARROUPILHA ADMINISTRADORA DE CONSÓRCIOS LTDA.;Insatisfação com a resposta fornecida pela administradora de consórcio relativa à demanda registrada contra ela;0;1;0;1;
2022;2º;91107581;FARROUPILHA ADMINISTRADORA DE CONSÓRCIOS LTDA.;Irregularidades relacionadas a informações e liquidação de valores a receber no sistema SVR do BCB por parte de consórcios;31;4;0;35;
2022;2º;91107581;FARROUPILHA ADMINISTRADORA DE CONSÓRCIOS LTDA.;Irregularidades relativas a integridade, confiabilidade, segurança, sigilo ou legitimidade das operações e serviços prestados relacionados a administradora de consórcio;1;0;0;1;
2022;2º;33350620;FEDERACAO NAC. DE ASSOCIACOES DOS SERVIDORES DO BCO CENTRAL;Irregularidades relacionadas a informações e liquidação de valores a receber no sistema SVR do BCB por parte de consórcios;0;1;0;1;
2022;2º;45725975;FINAMA ADMINISTRADORA DE CONSORCIO LTDA;Irregularidades relativas a integridade, confiabilidade, segurança, sigilo ou legitimidade das operações e serviços prestados relacionados a administradora de consórcio;0;1;0;1;
2022;2º;04751943;FRANCAUTO ADMINISTRADORA DE CONSÓRCIO LTDA.;Irregularidades relacionadas a informações e liquidação de valores a receber no sistema SVR do BCB por parte de consórcios;2;1;0;3;
2022;2º;82942400;GAMBATTO ADMINISTRADORA DE CONSORCIOS LTDA.;Irregularidades relacionadas a informações e liquidação de valores a receber no sistema SVR do BCB por parte de consórcios;0;1;0;1;
2022;2º;82942400;GAMBATTO ADMINISTRADORA DE CONSORCIOS LTDA.;Irregularidades relacionadas às condições para contemplação por lance ou sorteio;0;1;0;1;
2022;2º;47820097;GAPLAN ADMINISTRADORA DE CONSÓRCIO LTDA.;Reclamações relacionadas a assuntos diversos;0;0;1;1;
2022;2º;49937055;GMAC ADMINISTRADORA DE CONSORCIOS LTDA;Ausência de transparência nas relações contratuais;0;0;7;7;
2022;2º;49937055;GMAC ADMINISTRADORA DE CONSORCIOS LTDA;Cancelamento de contrato a pedido do cliente não atendido por administradora de consórcio;0;2;0;2;
2022;2º;49937055;GMAC ADMINISTRADORA DE CONSORCIOS LTDA;Descumprimento de cláusulas referentes à devolução de valores;1;5;0;6;
2022;2º;49937055;GMAC ADMINISTRADORA DE CONSORCIOS LTDA;Descumprimento de obrigações previstas em contratos;0;5;0;5;
2022;2º;49937055;GMAC ADMINISTRADORA DE CONSORCIOS LTDA;Descumprimento de prazo de resposta a demanda;1;2;0;3;
2022;2º;49937055;GMAC ADMINISTRADORA DE CONSORCIOS LTDA;Insatisfação com a resposta fornecida pela administradora de consórcio relativa à demanda registrada contra ela;0;3;0;3;
2022;2º;49937055;GMAC ADMINISTRADORA DE CONSORCIOS LTDA;Insatisfação por parte do cliente com o atendimento prestado pela administradora de consórcio;0;0;3;3;
2022;2º;49937055;GMAC ADMINISTRADORA DE CONSORCIOS LTDA;Irregularidades relacionadas a informações e liquidação de valores a receber no sistema SVR do BCB por parte de consórcios;35;57;0;92;
2022;2º;49937055;GMAC ADMINISTRADORA DE CONSORCIOS LTDA;Irregularidades relacionadas à liberação do crédito;0;19;0;19;
2022;2º;49937055;GMAC ADMINISTRADORA DE CONSORCIOS LTDA;Irregularidades relacionadas às condições para contemplação por lance ou sorteio;0;1;0;1;
2022;2º;49937055;GMAC ADMINISTRADORA DE CONSORCIOS LTDA;Irregularidades relativas a integridade, confiabilidade, segurança, sigilo ou legitimidade das operações e serviços prestados relacionados a administradora de consórcio;65;10;0;75;
2022;2º;49937055;GMAC ADMINISTRADORA DE CONSORCIOS LTDA;Não fornecimento, remessa ou divulgação de documentos por parte de administradora de consórcio;1;3;0;4;
2022;2º;49937055;GMAC ADMINISTRADORA DE CONSORCIOS LTDA;Oferta ou prestação de informação a respeito de produtos e serviços de forma inadequada por administradora de consórcio;7;5;0;12;
2022;2º;49937055;GMAC ADMINISTRADORA DE CONSORCIOS LTDA;Outras irregularidades relacionadas à Ouvidoria;1;0;0;1;
2022;2º;49937055;GMAC ADMINISTRADORA DE CONSORCIOS LTDA;Reclamações relacionadas a assuntos diversos;0;0;4;4;
2022;2º;91338228;GRAVEL ADMINISTRADORA DE CONSÓRCIOS LTDA.;Irregularidades relacionadas a informações e liquidação de valores a receber no sistema SVR do BCB por parte de consórcios;1;3;0;4;
2022;2º;91338228;GRAVEL ADMINISTRADORA DE CONSÓRCIOS LTDA.;Irregularidades relativas a integridade, confiabilidade, segurança, sigilo ou legitimidade das operações e serviços prestados relacionados a administradora de consórcio;1;0;0;1;
2022;2º;26228270;GROSCON ADMINISTRADORA DE CONSORCIOS LTDA.;Descumprimento de obrigações previstas em contratos;0;1;0;1;
2022;2º;26228270;GROSCON ADMINISTRADORA DE CONSORCIOS LTDA.;Oferta ou prestação de informação a respeito de produtos e serviços de forma inadequada por administradora de consórcio;0;1;0;1;
2022;2º;73516106;HS ADMINISTRADORA DE CONSÓRCIOS LTDA;Descumprimento de obrigações previstas em contratos;0;4;0;4;
2022;2º;73516106;HS ADMINISTRADORA DE CONSÓRCIOS LTDA;Insatisfação com a resposta fornecida pela administradora de consórcio relativa à demanda registrada contra ela;0;1;0;1;
2022;2º;73516106;HS ADMINISTRADORA DE CONSÓRCIOS LTDA;Insatisfação por parte do cliente com o atendimento prestado pela administradora de consórcio;0;0;1;1;
2022;2º;73516106;HS ADMINISTRADORA DE CONSÓRCIOS LTDA;Irregularidades relacionadas a informações e liquidação de valores a receber no sistema SVR do BCB por parte de consórcios;12;3;0;15;
2022;2º;73516106;HS ADMINISTRADORA DE CONSÓRCIOS LTDA;Irregularidades relacionadas à liberação do crédito;2;11;0;13;
2022;2º;73516106;HS ADMINISTRADORA DE CONSÓRCIOS LTDA;Irregularidades relativas a integridade, confiabilidade, segurança, sigilo ou legitimidade das operações e serviços prestados relacionados a administradora de consórcio;4;5;0;9;
2022;2º;03403333;IRMÃOS DE MARCO ADMINISTRADORA DE CONSÓRCIOS LTDA.;Irregularidades relacionadas a informações e liquidação de valores a receber no sistema SVR do BCB por parte de consórcios;1;0;0;1;
2022;2º;00000776;ITAÚ ADMINISTRADORA DE CONSÓRCIOS LTDA.;Ausência de transparência nas relações contratuais;0;0;3;3;
2022;2º;00000776;ITAÚ ADMINISTRADORA DE CONSÓRCIOS LTDA.;Descumprimento de cláusulas referentes à devolução de valores;2;24;0;26;
2022;2º;00000776;ITAÚ ADMINISTRADORA DE CONSÓRCIOS LTDA.;Descumprimento de obrigações previstas em contratos;2;13;0;15;
2022;2º;00000776;ITAÚ ADMINISTRADORA DE CONSÓRCIOS LTDA.;Descumprimento de prazo de resposta a demanda;0;2;0;2;
2022;2º;00000776;ITAÚ ADMINISTRADORA DE CONSÓRCIOS LTDA.;Insatisfação com a resposta fornecida pela administradora de consórcio relativa à demanda registrada contra ela;3;8;0;11;
2022;2º;00000776;ITAÚ ADMINISTRADORA DE CONSÓRCIOS LTDA.;Insatisfação por parte do cliente com o atendimento prestado pela administradora de consórcio;0;0;4;4;
2022;2º;00000776;ITAÚ ADMINISTRADORA DE CONSÓRCIOS LTDA.;Irregularidades relacionadas a informações e liquidação de valores a receber no sistema SVR do BCB por parte de consórcios;2;2;0;4;
2022;2º;00000776;ITAÚ ADMINISTRADORA DE CONSÓRCIOS LTDA.;Irregularidades relacionadas à liberação do crédito;5;38;0;43;
2022;2º;00000776;ITAÚ ADMINISTRADORA DE CONSÓRCIOS LTDA.;Irregularidades relacionadas às condições para contemplação por lance ou sorteio;3;7;0;10;
2022;2º;00000776;ITAÚ ADMINISTRADORA DE CONSÓRCIOS LTDA.;Irregularidades relativas a integridade, confiabilidade, segurança, sigilo ou legitimidade das operações e serviços prestados relacionados a administradora de consórcio;54;31;0;85;
2022;2º;00000776;ITAÚ ADMINISTRADORA DE CONSÓRCIOS LTDA.;Não fornecimento, remessa ou divulgação de documentos por parte de administradora de consórcio;3;4;0;7;
2022;2º;00000776;ITAÚ ADMINISTRADORA DE CONSÓRCIOS LTDA.;Oferta ou prestação de informação a respeito de produtos e serviços de forma inadequada por administradora de consórcio;17;13;0;30;
2022;2º;00000776;ITAÚ ADMINISTRADORA DE CONSÓRCIOS LTDA.;Reclamações relacionadas a assuntos diversos;0;0;5;5;
2022;2º;37137767;JORLAN ADMINISTRADORA DE CONSÓRCIO LTDA.;Irregularidades relacionadas a informações e liquidação de valores a receber no sistema SVR do BCB por parte de consórcios;2;1;0;3;
2022;2º;41629070;KLUBI ADMINISTRADORA DE CONSÓRCIOS LTDA.;Ausência de transparência nas relações contratuais;0;0;1;1;
2022;2º;41629070;KLUBI ADMINISTRADORA DE CONSÓRCIOS LTDA.;Descumprimento de obrigações previstas em contratos;0;1;0;1;
2022;2º;41629070;KLUBI ADMINISTRADORA DE CONSÓRCIOS LTDA.;Irregularidades relacionadas à liberação do crédito;0;1;0;1;
2022;2º;41629070;KLUBI ADMINISTRADORA DE CONSÓRCIOS LTDA.;Oferta ou prestação de informação a respeito de produtos e serviços de forma inadequada por administradora de consórcio;1;0;0;1;
2022;2º;41629070;KLUBI ADMINISTRADORA DE CONSÓRCIOS LTDA.;Reclamações relacionadas a assuntos diversos;0;0;1;1;
2022;2º;60250776;LUIZA ADMINISTRADORA DE CONSÓRCIOS LTDA;Descumprimento de cláusulas referentes à devolução de valores;0;2;0;2;
2022;2º;60250776;LUIZA ADMINISTRADORA DE CONSÓRCIOS LTDA;Descumprimento de obrigações previstas em contratos;0;1;0;1;
2022;2º;60250776;LUIZA ADMINISTRADORA DE CONSÓRCIOS LTDA;Irregularidades relacionadas a informações e liquidação de valores a receber no sistema SVR do BCB por parte de consórcios;2;1;0;3;
2022;2º;60250776;LUIZA ADMINISTRADORA DE CONSÓRCIOS LTDA;Irregularidades relacionadas à liberação do crédito;0;6;0;6;
2022;2º;60250776;LUIZA ADMINISTRADORA DE CONSÓRCIOS LTDA;Irregularidades relativas a integridade, confiabilidade, segurança, sigilo ou legitimidade das operações e serviços prestados relacionados a administradora de consórcio;2;0;0;2;
2022;2º;60250776;LUIZA ADMINISTRADORA DE CONSÓRCIOS LTDA;Oferta ou prestação de informação a respeito de produtos e serviços de forma inadequada por administradora de consórcio;0;1;0;1;
2022;2º;04250224;MAGGI ADMINISTRADORA DE CONSÓRCIOS LTDA;Irregularidades relacionadas a informações e liquidação de valores a receber no sistema SVR do BCB por parte de consórcios;3;1;0;4;
2022;2º;04250224;MAGGI ADMINISTRADORA DE CONSÓRCIOS LTDA;Reclamações relacionadas a assuntos diversos;0;0;1;1;
2022;2º;45793395;MASSEY FERGUSON ADMINISTRADORA DE CONSÓRCIOS LTDA;Irregularidades relacionadas a informações e liquidação de valores a receber no sistema SVR do BCB por parte de consórcios;7;2;0;9;
2022;2º;76853043;MENEGALLI ADMINISTRADORA DE CONSÓRCIOS LTDA;Irregularidades relacionadas a informações e liquidação de valores a receber no sistema SVR do BCB por parte de consórcios;1;2;0;3;
2022;2º;46349106;MERCABENCO ADMINISTRADORA DE CONSORCIO LTDA;Descumprimento de cláusulas referentes à devolução de valores;0;1;0;1;
2022;2º;46349106;MERCABENCO ADMINISTRADORA DE CONSORCIO LTDA;Descumprimento de obrigações previstas em contratos;0;1;0;1;
2022;2º;46349106;MERCABENCO ADMINISTRADORA DE CONSORCIO LTDA;Insatisfação por parte do cliente com o atendimento prestado pela administradora de consórcio;0;0;1;1;
2022;2º;04124922;MULTIMARCAS ADMINISTRADORA DE CONSORCIOS LTDA.;Descumprimento de cláusulas referentes à devolução de valores;0;7;0;7;
2022;2º;04124922;MULTIMARCAS ADMINISTRADORA DE CONSORCIOS LTDA.;Descumprimento de obrigações previstas em contratos;1;2;0;3;
2022;2º;04124922;MULTIMARCAS ADMINISTRADORA DE CONSORCIOS LTDA.;Insatisfação com a resposta fornecida pela administradora de consórcio relativa à demanda registrada contra ela;1;7;0;8;
2022;2º;04124922;MULTIMARCAS ADMINISTRADORA DE CONSORCIOS LTDA.;Insatisfação por parte do cliente com o atendimento prestado pela administradora de consórcio;0;0;1;1;
2022;2º;04124922;MULTIMARCAS ADMINISTRADORA DE CONSORCIOS LTDA.;Irregularidades relacionadas a informações e liquidação de valores a receber no sistema SVR do BCB por parte de consórcios;1;6;0;7;
2022;2º;04124922;MULTIMARCAS ADMINISTRADORA DE CONSORCIOS LTDA.;Irregularidades relativas a integridade, confiabilidade, segurança, sigilo ou legitimidade das operações e serviços prestados relacionados a administradora de consórcio;3;1;0;4;
2022;2º;04124922;MULTIMARCAS ADMINISTRADORA DE CONSORCIOS LTDA.;Não fornecimento, remessa ou divulgação de documentos por parte de administradora de consórcio;1;1;0;2;
2022;2º;04124922;MULTIMARCAS ADMINISTRADORA DE CONSORCIOS LTDA.;Oferta ou prestação de informação a respeito de produtos e serviços de forma inadequada por administradora de consórcio;15;8;0;23;
2022;2º;04124922;MULTIMARCAS ADMINISTRADORA DE CONSORCIOS LTDA.;Reclamações relacionadas a assuntos diversos;0;0;2;2;
2022;2º;05652765;NANUQUE ADMINISTRADORA DE CONSÓRCIOS LTDA.;Descumprimento de obrigações previstas em contratos;0;1;0;1;
2022;2º;05652765;NANUQUE ADMINISTRADORA DE CONSÓRCIOS LTDA.;Irregularidades relativas a integridade, confiabilidade, segurança, sigilo ou legitimidade das operações e serviços prestados relacionados a administradora de consórcio;2;0;0;2;
2022;2º;48041735;PORTO SEGURO ADMINISTRADORA DE CONSÓRCIOS LTDA;Ausência de transparência nas relações contratuais;0;0;2;2;
2022;2º;48041735;PORTO SEGURO ADMINISTRADORA DE CONSÓRCIOS LTDA;Cancelamento de contrato a pedido do cliente não atendido por administradora de consórcio;0;1;0;1;
2022;2º;48041735;PORTO SEGURO ADMINISTRADORA DE CONSÓRCIOS LTDA;Descumprimento de cláusulas referentes à devolução de valores;0;6;0;6;
2022;2º;48041735;PORTO SEGURO ADMINISTRADORA DE CONSÓRCIOS LTDA;Descumprimento de obrigações previstas em contratos;1;13;0;14;
2022;2º;48041735;PORTO SEGURO ADMINISTRADORA DE CONSÓRCIOS LTDA;Descumprimento de prazo de resposta a demanda;1;0;0;1;
2022;2º;48041735;PORTO SEGURO ADMINISTRADORA DE CONSÓRCIOS LTDA;Insatisfação com a resposta fornecida pela administradora de consórcio relativa à demanda registrada contra ela;0;5;0;5;
2022;2º;48041735;PORTO SEGURO ADMINISTRADORA DE CONSÓRCIOS LTDA;Insatisfação por parte do cliente com o atendimento prestado pela administradora de consórcio;0;0;3;3;
2022;2º;48041735;PORTO SEGURO ADMINISTRADORA DE CONSÓRCIOS LTDA;Irregularidades relacionadas a informações e liquidação de valores a receber no sistema SVR do BCB por parte de consórcios;72;36;0;108;
2022;2º;48041735;PORTO SEGURO ADMINISTRADORA DE CONSÓRCIOS LTDA;Irregularidades relacionadas à liberação do crédito;0;6;0;6;
2022;2º;48041735;PORTO SEGURO ADMINISTRADORA DE CONSÓRCIOS LTDA;Irregularidades relacionadas às condições para contemplação por lance ou sorteio;0;5;0;5;
2022;2º;48041735;PORTO SEGURO ADMINISTRADORA DE CONSÓRCIOS LTDA;Irregularidades relativas a integridade, confiabilidade, segurança, sigilo ou legitimidade das operações e serviços prestados relacionados a administradora de consórcio;83;16;0;99;
2022;2º;48041735;PORTO SEGURO ADMINISTRADORA DE CONSÓRCIOS LTDA;Não fornecimento, remessa ou divulgação de documentos por parte de administradora de consórcio;0;1;0;1;
2022;2º;48041735;PORTO SEGURO ADMINISTRADORA DE CONSÓRCIOS LTDA;Oferta ou prestação de informação a respeito de produtos e serviços de forma inadequada por administradora de consórcio;5;2;0;7;
2022;2º;48041735;PORTO SEGURO ADMINISTRADORA DE CONSÓRCIOS LTDA;Reclamações relacionadas a assuntos diversos;0;0;4;4;
2022;2º;87433413;PORTOBENS ADMINISTRADORA DE CONSORCIOS LTDA;Irregularidades relativas a integridade, confiabilidade, segurança, sigilo ou legitimidade das operações e serviços prestados relacionados a administradora de consórcio;0;1;0;1;
2022;2º;87433413;PORTOBENS ADMINISTRADORA DE CONSORCIOS LTDA;Não fornecimento, remessa ou divulgação de documentos por parte de administradora de consórcio;0;1;0;1;
2022;2º;51597300;PRIMO ROSSI ADMINISTRADORA DE CONSÓRCIO LTDA.;Irregularidades relacionadas a informações e liquidação de valores a receber no sistema SVR do BCB por parte de consórcios;1;1;0;2;
2022;2º;51597300;PRIMO ROSSI ADMINISTRADORA DE CONSÓRCIO LTDA.;Irregularidades relacionadas à liberação do crédito;0;2;0;2;
2022;2º;51597300;PRIMO ROSSI ADMINISTRADORA DE CONSÓRCIO LTDA.;Irregularidades relativas a integridade, confiabilidade, segurança, sigilo ou legitimidade das operações e serviços prestados relacionados a administradora de consórcio;2;0;0;2;
2022;2º;09111444;PROMOVE ADMINISTRADORA DE CONSÓRCIO LTDA.;Descumprimento de cláusulas referentes à devolução de valores;0;1;0;1;
2022;2º;09111444;PROMOVE ADMINISTRADORA DE CONSÓRCIO LTDA.;Irregularidades relativas a integridade, confiabilidade, segurança, sigilo ou legitimidade das operações e serviços prestados relacionados a administradora de consórcio;1;0;0;1;
2022;2º;09111444;PROMOVE ADMINISTRADORA DE CONSÓRCIO LTDA.;Oferta ou prestação de informação a respeito de produtos e serviços de forma inadequada por administradora de consórcio;15;0;0;15;
2022;2º;91108027;RANDON ADMINISTRADORA DE CONSÓRCIOS LTDA.;Descumprimento de obrigações previstas em contratos;0;2;0;2;
2022;2º;91108027;RANDON ADMINISTRADORA DE CONSÓRCIOS LTDA.;Insatisfação com a resposta fornecida pela administradora de consórcio relativa à demanda registrada contra ela;0;1;0;1;
2022;2º;91108027;RANDON ADMINISTRADORA DE CONSÓRCIOS LTDA.;Irregularidades relacionadas a informações e liquidação de valores a receber no sistema SVR do BCB por parte de consórcios;0;1;0;1;
2022;2º;91108027;RANDON ADMINISTRADORA DE CONSÓRCIOS LTDA.;Irregularidades relacionadas às condições para contemplação por lance ou sorteio;1;1;0;2;
2022;2º;91108027;RANDON ADMINISTRADORA DE CONSÓRCIOS LTDA.;Irregularidades relativas a integridade, confiabilidade, segurança, sigilo ou legitimidade das operações e serviços prestados relacionados a administradora de consórcio;2;2;0;4;
2022;2º;06181431;RCN ADMINISTRADORA DE CONSORCIO NACIONAL LTDA;Insatisfação com a resposta fornecida pela administradora de consórcio relativa à demanda registrada contra ela;0;1;0;1;
2022;2º;06181431;RCN ADMINISTRADORA DE CONSORCIO NACIONAL LTDA;Irregularidades relacionadas a informações e liquidação de valores a receber no sistema SVR do BCB por parte de consórcios;1;0;0;1;
2022;2º;06181431;RCN ADMINISTRADORA DE CONSORCIO NACIONAL LTDA;Oferta ou prestação de informação a respeito de produtos e serviços de forma inadequada por administradora de consórcio;1;0;0;1;
2022;2º;23767155;RECON ADMINISTRADORA DE CONSORCIOS LTDA;Descumprimento de cláusulas referentes à devolução de valores;0;1;0;1;
2022;2º;23767155;RECON ADMINISTRADORA DE CONSORCIOS LTDA;Descumprimento de obrigações previstas em contratos;0;1;0;1;
2022;2º;23767155;RECON ADMINISTRADORA DE CONSORCIOS LTDA;Não fornecimento, remessa ou divulgação de documentos por parte de administradora de consórcio;1;1;0;2;
2022;2º;23767155;RECON ADMINISTRADORA DE CONSORCIOS LTDA;Oferta ou prestação de informação a respeito de produtos e serviços de forma inadequada por administradora de consórcio;1;0;0;1;
2022;2º;62354055;REMAZA ADMINISTRADORA DE CONSÓRCIO LTDA.;Descumprimento de cláusulas referentes à devolução de valores;0;5;0;5;
2022;2º;62354055;REMAZA ADMINISTRADORA DE CONSÓRCIO LTDA.;Descumprimento de obrigações previstas em contratos;0;3;0;3;
2022;2º;62354055;REMAZA ADMINISTRADORA DE CONSÓRCIO LTDA.;Insatisfação com a resposta fornecida pela administradora de consórcio relativa à demanda registrada contra ela;0;2;0;2;
2022;2º;62354055;REMAZA ADMINISTRADORA DE CONSÓRCIO LTDA.;Insatisfação por parte do cliente com o atendimento prestado pela administradora de consórcio;0;0;1;1;
2022;2º;62354055;REMAZA ADMINISTRADORA DE CONSÓRCIO LTDA.;Irregularidades relacionadas a informações e liquidação de valores a receber no sistema SVR do BCB por parte de consórcios;2;8;0;10;
2022;2º;62354055;REMAZA ADMINISTRADORA DE CONSÓRCIO LTDA.;Irregularidades relacionadas à liberação do crédito;0;1;0;1;
2022;2º;62354055;REMAZA ADMINISTRADORA DE CONSÓRCIO LTDA.;Irregularidades relativas a integridade, confiabilidade, segurança, sigilo ou legitimidade das operações e serviços prestados relacionados a administradora de consórcio;4;0;0;4;
2022;2º;62354055;REMAZA ADMINISTRADORA DE CONSÓRCIO LTDA.;Não fornecimento, remessa ou divulgação de documentos por parte de administradora de consórcio;1;0;0;1;
2022;2º;62354055;REMAZA ADMINISTRADORA DE CONSÓRCIO LTDA.;Oferta ou prestação de informação a respeito de produtos e serviços de forma inadequada por administradora de consórcio;3;2;0;5;
2022;2º;62354055;REMAZA ADMINISTRADORA DE CONSÓRCIO LTDA.;Outras irregularidades relacionadas à Ouvidoria;1;0;0;1;
2022;2º;28904092;RESERVA ADMINISTRADORA DE CONSÓRCIO LTDA;Descumprimento de cláusulas referentes à devolução de valores;0;2;0;2;
2022;2º;28904092;RESERVA ADMINISTRADORA DE CONSÓRCIO LTDA;Descumprimento de obrigações previstas em contratos;0;2;0;2;
2022;2º;28904092;RESERVA ADMINISTRADORA DE CONSÓRCIO LTDA;Insatisfação com a resposta fornecida pela administradora de consórcio relativa à demanda registrada contra ela;0;3;0;3;
2022;2º;28904092;RESERVA ADMINISTRADORA DE CONSÓRCIO LTDA;Irregularidades relativas a integridade, confiabilidade, segurança, sigilo ou legitimidade das operações e serviços prestados relacionados a administradora de consórcio;1;0;0;1;
2022;2º;28904092;RESERVA ADMINISTRADORA DE CONSÓRCIO LTDA;Oferta ou prestação de informação a respeito de produtos e serviços de forma inadequada por administradora de consórcio;24;4;0;28;
2022;2º;51855716;RODOBENS ADMINISTRADORA DE CONSÓRCIOS LTDA.;Ausência de transparência nas relações contratuais;0;0;1;1;
2022;2º;51855716;RODOBENS ADMINISTRADORA DE CONSÓRCIOS LTDA.;Descumprimento de cláusulas referentes à devolução de valores;1;12;0;13;
2022;2º;51855716;RODOBENS ADMINISTRADORA DE CONSÓRCIOS LTDA.;Descumprimento de obrigações previstas em contratos;0;8;0;8;
2022;2º;51855716;RODOBENS ADMINISTRADORA DE CONSÓRCIOS LTDA.;Insatisfação com a resposta fornecida pela administradora de consórcio relativa à demanda registrada contra ela;1;1;0;2;
2022;2º;51855716;RODOBENS ADMINISTRADORA DE CONSÓRCIOS LTDA.;Insatisfação por parte do cliente com o atendimento prestado pela administradora de consórcio;0;0;3;3;
2022;2º;51855716;RODOBENS ADMINISTRADORA DE CONSÓRCIOS LTDA.;Irregularidades relacionadas a informações e liquidação de valores a receber no sistema SVR do BCB por parte de consórcios;3;16;0;19;
2022;2º;51855716;RODOBENS ADMINISTRADORA DE CONSÓRCIOS LTDA.;Irregularidades relacionadas à liberação do crédito;0;9;0;9;
2022;2º;51855716;RODOBENS ADMINISTRADORA DE CONSÓRCIOS LTDA.;Irregularidades relacionadas às condições para contemplação por lance ou sorteio;0;5;0;5;
2022;2º;51855716;RODOBENS ADMINISTRADORA DE CONSÓRCIOS LTDA.;Irregularidades relativas a integridade, confiabilidade, segurança, sigilo ou legitimidade das operações e serviços prestados relacionados a administradora de consórcio;17;22;0;39;
2022;2º;51855716;RODOBENS ADMINISTRADORA DE CONSÓRCIOS LTDA.;Não fornecimento, remessa ou divulgação de documentos por parte de administradora de consórcio;1;1;0;2;
2022;2º;51855716;RODOBENS ADMINISTRADORA DE CONSÓRCIOS LTDA.;Oferta ou prestação de informação a respeito de produtos e serviços de forma inadequada por administradora de consórcio;4;3;0;7;
2022;2º;51855716;RODOBENS ADMINISTRADORA DE CONSÓRCIOS LTDA.;Outras irregularidades relacionadas à Ouvidoria;0;1;0;1;
2022;2º;51855716;RODOBENS ADMINISTRADORA DE CONSÓRCIOS LTDA.;Reclamações relacionadas a assuntos diversos;0;0;6;6;
2022;2º;55942312;SANTANDER BRASIL ADMINISTRADORA DE CONSÓRCIO LTDA.;Ausência de transparência nas relações contratuais;0;0;1;1;
2022;2º;55942312;SANTANDER BRASIL ADMINISTRADORA DE CONSÓRCIO LTDA.;Cobrança irregular de tarifa pela emissão de boletos, carnês e assemelhados;1;0;0;1;
2022;2º;55942312;SANTANDER BRASIL ADMINISTRADORA DE CONSÓRCIO LTDA.;Descumprimento de cláusulas referentes à devolução de valores;2;17;0;19;
2022;2º;55942312;SANTANDER BRASIL ADMINISTRADORA DE CONSÓRCIO LTDA.;Descumprimento de obrigações previstas em contratos;3;33;0;36;
2022;2º;55942312;SANTANDER BRASIL ADMINISTRADORA DE CONSÓRCIO LTDA.;Descumprimento de prazo de resposta a demanda;0;1;0;1;
2022;2º;55942312;SANTANDER BRASIL ADMINISTRADORA DE CONSÓRCIO LTDA.;Insatisfação com a resposta fornecida pela administradora de consórcio relativa à demanda registrada contra ela;2;16;0;18;
2022;2º;55942312;SANTANDER BRASIL ADMINISTRADORA DE CONSÓRCIO LTDA.;Insatisfação por parte do cliente com o atendimento prestado pela administradora de consórcio;0;0;10;10;
2022;2º;55942312;SANTANDER BRASIL ADMINISTRADORA DE CONSÓRCIO LTDA.;Irregularidades relacionadas a informações e liquidação de valores a receber no sistema SVR do BCB por parte de consórcios;101;19;0;120;
2022;2º;55942312;SANTANDER BRASIL ADMINISTRADORA DE CONSÓRCIO LTDA.;Irregularidades relacionadas à liberação do crédito;4;79;0;83;
2022;2º;55942312;SANTANDER BRASIL ADMINISTRADORA DE CONSÓRCIO LTDA.;Irregularidades relacionadas às condições para contemplação por lance ou sorteio;0;7;0;7;
2022;2º;55942312;SANTANDER BRASIL ADMINISTRADORA DE CONSÓRCIO LTDA.;Irregularidades relativas a integridade, confiabilidade, segurança, sigilo ou legitimidade das operações e serviços prestados relacionados a administradora de consórcio;105;41;0;146;
2022;2º;55942312;SANTANDER BRASIL ADMINISTRADORA DE CONSÓRCIO LTDA.;Não fornecimento, remessa ou divulgação de documentos por parte de administradora de consórcio;1;7;0;8;
2022;2º;55942312;SANTANDER BRASIL ADMINISTRADORA DE CONSÓRCIO LTDA.;Oferta ou prestação de informação a respeito de produtos e serviços de forma inadequada por administradora de consórcio;21;10;0;31;
2022;2º;55942312;SANTANDER BRASIL ADMINISTRADORA DE CONSÓRCIO LTDA.;Outras irregularidades;0;1;0;1;
2022;2º;55942312;SANTANDER BRASIL ADMINISTRADORA DE CONSÓRCIO LTDA.;Reclamações relacionadas a assuntos diversos;0;0;19;19;
2022;2º;96479258;SCANIA ADMINISTRADORA DE CONSÓRCIOS LTDA.;Descumprimento de cláusulas referentes à devolução de valores;0;1;0;1;
2022;2º;96479258;SCANIA ADMINISTRADORA DE CONSÓRCIOS LTDA.;Descumprimento de obrigações previstas em contratos;0;2;0;2;
2022;2º;96479258;SCANIA ADMINISTRADORA DE CONSÓRCIOS LTDA.;Irregularidades relacionadas a informações e liquidação de valores a receber no sistema SVR do BCB por parte de consórcios;1;0;0;1;
2022;2º;96479258;SCANIA ADMINISTRADORA DE CONSÓRCIOS LTDA.;Irregularidades relativas a integridade, confiabilidade, segurança, sigilo ou legitimidade das operações e serviços prestados relacionados a administradora de consórcio;1;0;0;1;
2022;2º;96479258;SCANIA ADMINISTRADORA DE CONSÓRCIOS LTDA.;Não fornecimento, remessa ou divulgação de documentos por parte de administradora de consórcio;1;0;0;1;
2022;2º;96479258;SCANIA ADMINISTRADORA DE CONSÓRCIOS LTDA.;Reclamações relacionadas a assuntos diversos;0;0;1;1;
2022;2º;76515071;SERVOPA ADMINISTRADORA DE CONSORCIOS LTDA;Descumprimento de cláusulas referentes à devolução de valores;0;1;0;1;
2022;2º;76515071;SERVOPA ADMINISTRADORA DE CONSORCIOS LTDA;Descumprimento de obrigações previstas em contratos;0;1;0;1;
2022;2º;76515071;SERVOPA ADMINISTRADORA DE CONSORCIOS LTDA;Irregularidades relacionadas a informações e liquidação de valores a receber no sistema SVR do BCB por parte de consórcios;0;1;0;1;
2022;2º;76515071;SERVOPA ADMINISTRADORA DE CONSORCIOS LTDA;Irregularidades relacionadas à liberação do crédito;0;2;0;2;
2022;2º;76515071;SERVOPA ADMINISTRADORA DE CONSORCIOS LTDA;Irregularidades relativas a integridade, confiabilidade, segurança, sigilo ou legitimidade das operações e serviços prestados relacionados a administradora de consórcio;1;0;0;1;
2022;2º;76515071;SERVOPA ADMINISTRADORA DE CONSORCIOS LTDA;Oferta ou prestação de informação a respeito de produtos e serviços de forma inadequada por administradora de consórcio;0;1;0;1;
2022;2º;16551061;SICOOB ADMINISTRADORA DE CONSÓRCIOS LTDA.;Ausência de transparência nas relações contratuais;0;0;1;1;
2022;2º;16551061;SICOOB ADMINISTRADORA DE CONSÓRCIOS LTDA.;Cancelamento de contrato a pedido do cliente não atendido por administradora de consórcio;0;1;0;1;
2022;2º;16551061;SICOOB ADMINISTRADORA DE CONSÓRCIOS LTDA.;Descumprimento de cláusulas referentes à devolução de valores;0;3;0;3;
2022;2º;16551061;SICOOB ADMINISTRADORA DE CONSÓRCIOS LTDA.;Descumprimento de obrigações previstas em contratos;3;9;0;12;
2022;2º;16551061;SICOOB ADMINISTRADORA DE CONSÓRCIOS LTDA.;Descumprimento de prazo de resposta a demanda;1;0;0;1;
2022;2º;16551061;SICOOB ADMINISTRADORA DE CONSÓRCIOS LTDA.;Insatisfação com a resposta fornecida pela administradora de consórcio relativa à demanda registrada contra ela;0;2;0;2;
2022;2º;16551061;SICOOB ADMINISTRADORA DE CONSÓRCIOS LTDA.;Insatisfação por parte do cliente com o atendimento prestado pela administradora de consórcio;0;0;2;2;
2022;2º;16551061;SICOOB ADMINISTRADORA DE CONSÓRCIOS LTDA.;Irregularidades relacionadas a informações e liquidação de valores a receber no sistema SVR do BCB por parte de consórcios;0;8;0;8;
2022;2º;16551061;SICOOB ADMINISTRADORA DE CONSÓRCIOS LTDA.;Irregularidades relacionadas à liberação do crédito;1;15;0;16;
2022;2º;16551061;SICOOB ADMINISTRADORA DE CONSÓRCIOS LTDA.;Irregularidades relacionadas às condições para contemplação por lance ou sorteio;0;3;0;3;
2022;2º;16551061;SICOOB ADMINISTRADORA DE CONSÓRCIOS LTDA.;Irregularidades relativas a integridade, confiabilidade, segurança, sigilo ou legitimidade das operações e serviços prestados relacionados a administradora de consórcio;16;4;0;20;
2022;2º;16551061;SICOOB ADMINISTRADORA DE CONSÓRCIOS LTDA.;Não fornecimento, remessa ou divulgação de documentos por parte de administradora de consórcio;3;0;0;3;
2022;2º;16551061;SICOOB ADMINISTRADORA DE CONSÓRCIOS LTDA.;Oferta ou prestação de informação a respeito de produtos e serviços de forma inadequada por administradora de consórcio;8;1;0;9;
2022;2º;16551061;SICOOB ADMINISTRADORA DE CONSÓRCIOS LTDA.;Outras irregularidades;0;1;0;1;
2022;2º;16551061;SICOOB ADMINISTRADORA DE CONSÓRCIOS LTDA.;Reclamações relacionadas a assuntos diversos;0;0;3;3;
2022;2º;87945218;SIMPALA LANÇADORA E ADMINISTRADORA DE CONSÓRCIOS LTDA.;Cancelamento de contrato a pedido do cliente não atendido por administradora de consórcio;0;1;0;1;
2022;2º;87945218;SIMPALA LANÇADORA E ADMINISTRADORA DE CONSÓRCIOS LTDA.;Descumprimento de obrigações previstas em contratos;0;2;0;2;
2022;2º;87945218;SIMPALA LANÇADORA E ADMINISTRADORA DE CONSÓRCIOS LTDA.;Insatisfação com a resposta fornecida pela administradora de consórcio relativa à demanda registrada contra ela;0;1;0;1;
2022;2º;87945218;SIMPALA LANÇADORA E ADMINISTRADORA DE CONSÓRCIOS LTDA.;Irregularidades relativas a integridade, confiabilidade, segurança, sigilo ou legitimidade das operações e serviços prestados relacionados a administradora de consórcio;2;0;0;2;
2022;2º;87945218;SIMPALA LANÇADORA E ADMINISTRADORA DE CONSÓRCIOS LTDA.;Oferta ou prestação de informação a respeito de produtos e serviços de forma inadequada por administradora de consórcio;11;3;0;14;
2022;2º;87945218;SIMPALA LANÇADORA E ADMINISTRADORA DE CONSÓRCIOS LTDA.;Outras irregularidades relacionadas à Ouvidoria;1;0;0;1;
2022;2º;87852273;SINOSSERRA ADMINISTRADORA DE CONSÓRCIOS LTDA;Descumprimento de cláusulas referentes à devolução de valores;0;2;0;2;
2022;2º;87636635;SPONCHIADO ADMINISTRADORA DE CONSÓRCIOS LTDA.;Irregularidades relacionadas a informações e liquidação de valores a receber no sistema SVR do BCB por parte de consórcios;3;4;0;7;
2022;2º;87636635;SPONCHIADO ADMINISTRADORA DE CONSÓRCIOS LTDA.;Irregularidades relativas a integridade, confiabilidade, segurança, sigilo ou legitimidade das operações e serviços prestados relacionados a administradora de consórcio;1;2;0;3;
2022;2º;57723801;SUZUKI MOTOS ADMINISTRADORA DE CONSÓRCIO LTDA.;Cancelamento de contrato a pedido do cliente não atendido por administradora de consórcio;0;1;0;1;
2022;2º;57723801;SUZUKI MOTOS ADMINISTRADORA DE CONSÓRCIO LTDA.;Descumprimento de obrigações previstas em contratos;1;0;0;1;
2022;2º;57723801;SUZUKI MOTOS ADMINISTRADORA DE CONSÓRCIO LTDA.;Irregularidades relacionadas a informações e liquidação de valores a receber no sistema SVR do BCB por parte de consórcios;4;3;0;7;
2022;2º;57723801;SUZUKI MOTOS ADMINISTRADORA DE CONSÓRCIO LTDA.;Irregularidades relativas a integridade, confiabilidade, segurança, sigilo ou legitimidade das operações e serviços prestados relacionados a administradora de consórcio;1;0;0;1;
2022;2º;53211488;TARRAF ADMINISTRADORA DE CONSÓRCIOS LTDA.;Irregularidades relacionadas a informações e liquidação de valores a receber no sistema SVR do BCB por parte de consórcios;1;0;0;1;
2022;2º;05551841;TÁGIDE ADMINISTRADORA DE CONSÓRCIOS LTDA.;Insatisfação com a resposta fornecida pela administradora de consórcio relativa à demanda registrada contra ela;1;0;0;1;
2022;2º;05551841;TÁGIDE ADMINISTRADORA DE CONSÓRCIOS LTDA.;Irregularidades relativas a integridade, confiabilidade, segurança, sigilo ou legitimidade das operações e serviços prestados relacionados a administradora de consórcio;0;1;0;1;
2022;2º;05551841;TÁGIDE ADMINISTRADORA DE CONSÓRCIOS LTDA.;Oferta ou prestação de informação a respeito de produtos e serviços de forma inadequada por administradora de consórcio;5;0;0;5;
2022;2º;43707203;TOYOTA ADMINISTRADORA DE CONSÓRCIOS DO BRASIL LTDA.;Descumprimento de cláusulas referentes à devolução de valores;0;1;0;1;
2022;2º;59956185;TRADIÇÃO ADMINISTRADORA DE CONSÓRCIO LTDA.;Ausência de transparência nas relações contratuais;0;0;1;1;
2022;2º;59956185;TRADIÇÃO ADMINISTRADORA DE CONSÓRCIO LTDA.;Descumprimento de cláusulas referentes à devolução de valores;0;2;0;2;
2022;2º;59956185;TRADIÇÃO ADMINISTRADORA DE CONSÓRCIO LTDA.;Insatisfação com a resposta fornecida pela administradora de consórcio relativa à demanda registrada contra ela;0;2;0;2;
2022;2º;59956185;TRADIÇÃO ADMINISTRADORA DE CONSÓRCIO LTDA.;Insatisfação por parte do cliente com o atendimento prestado pela administradora de consórcio;0;0;1;1;
2022;2º;59956185;TRADIÇÃO ADMINISTRADORA DE CONSÓRCIO LTDA.;Irregularidades relacionadas a informações e liquidação de valores a receber no sistema SVR do BCB por parte de consórcios;0;1;0;1;
2022;2º;59956185;TRADIÇÃO ADMINISTRADORA DE CONSÓRCIO LTDA.;Irregularidades relacionadas à liberação do crédito;0;1;0;1;
2022;2º;59956185;TRADIÇÃO ADMINISTRADORA DE CONSÓRCIO LTDA.;Irregularidades relacionadas às condições para contemplação por lance ou sorteio;0;2;0;2;
2022;2º;59956185;TRADIÇÃO ADMINISTRADORA DE CONSÓRCIO LTDA.;Irregularidades relativas a integridade, confiabilidade, segurança, sigilo ou legitimidade das operações e serviços prestados relacionados a administradora de consórcio;5;2;0;7;
2022;2º;59956185;TRADIÇÃO ADMINISTRADORA DE CONSÓRCIO LTDA.;Não fornecimento, remessa ou divulgação de documentos por parte de administradora de consórcio;0;1;0;1;
2022;2º;59956185;TRADIÇÃO ADMINISTRADORA DE CONSÓRCIO LTDA.;Oferta ou prestação de informação a respeito de produtos e serviços de forma inadequada por administradora de consórcio;19;3;0;22;
2022;2º;59956185;TRADIÇÃO ADMINISTRADORA DE CONSÓRCIO LTDA.;Reclamações relacionadas a assuntos diversos;0;0;3;3;
2022;2º;78199262;TRIÂNGULO ADMINISTRADORA DE CONSÓRCIOS LTDA;Irregularidades relacionadas a informações e liquidação de valores a receber no sistema SVR do BCB por parte de consórcios;1;1;0;2;
2022;2º;83553883;UNIÃO CATARINENSE ADMINISTRADORA DE CONSORCIOS LTDA;Descumprimento de obrigações previstas em contratos;0;2;0;2;
2022;2º;83553883;UNIÃO CATARINENSE ADMINISTRADORA DE CONSORCIOS LTDA;Irregularidades relativas a integridade, confiabilidade, segurança, sigilo ou legitimidade das operações e serviços prestados relacionados a administradora de consórcio;0;2;0;2;
2022;2º;60732997;UNIFISA ADMINISTRADORA NACIONAL DE CONSORCIOS LTDA;Descumprimento de cláusulas referentes à devolução de valores;0;2;0;2;
2022;2º;60732997;UNIFISA ADMINISTRADORA NACIONAL DE CONSORCIOS LTDA;Descumprimento de obrigações previstas em contratos;0;3;0;3;
2022;2º;60732997;UNIFISA ADMINISTRADORA NACIONAL DE CONSORCIOS LTDA;Irregularidades relacionadas à liberação do crédito;0;3;0;3;
2022;2º;60732997;UNIFISA ADMINISTRADORA NACIONAL DE CONSORCIOS LTDA;Irregularidades relativas a integridade, confiabilidade, segurança, sigilo ou legitimidade das operações e serviços prestados relacionados a administradora de consórcio;2;3;0;5;
2022;2º;60732997;UNIFISA ADMINISTRADORA NACIONAL DE CONSORCIOS LTDA;Não fornecimento, remessa ou divulgação de documentos por parte de administradora de consórcio;0;1;0;1;
2022;2º;60732997;UNIFISA ADMINISTRADORA NACIONAL DE CONSORCIOS LTDA;Oferta ou prestação de informação a respeito de produtos e serviços de forma inadequada por administradora de consórcio;4;6;0;10;
2022;2º;60732997;UNIFISA ADMINISTRADORA NACIONAL DE CONSORCIOS LTDA;Reclamações relacionadas a assuntos diversos;0;0;1;1;
2022;2º;56360266;VALTRA ADMINISTRADORA DE CONSÓRCIOS LTDA;Descumprimento de obrigações previstas em contratos;0;1;0;1;
2022;2º;56360266;VALTRA ADMINISTRADORA DE CONSÓRCIOS LTDA;Irregularidades relacionadas a informações e liquidação de valores a receber no sistema SVR do BCB por parte de consórcios;4;2;0;6;
2022;2º;45594223;VEMAR ADMINISTRADORA DE CONSÓRCIO LTDA.;Irregularidades relacionadas a informações e liquidação de valores a receber no sistema SVR do BCB por parte de consórcios;1;0;0;1;
2022;2º;45594223;VEMAR ADMINISTRADORA DE CONSÓRCIO LTDA.;Irregularidades relativas a integridade, confiabilidade, segurança, sigilo ou legitimidade das operações e serviços prestados relacionados a administradora de consórcio;1;0;0;1;
2022;2º;49995293;VINAC ADMINISTRADORA DE CONSÓRCIOS LTDA.;Descumprimento de obrigações previstas em contratos;0;1;0;1;
2022;2º;49995293;VINAC ADMINISTRADORA DE CONSÓRCIOS LTDA.;Irregularidades relativas a integridade, confiabilidade, segurança, sigilo ou legitimidade das operações e serviços prestados relacionados a administradora de consórcio;1;0;0;1;
2022;2º;22245020;VIVIANI ADMINISTRADORA DE CONSÓRCIO NACIONAL LTDA.;Irregularidades relacionadas à liberação do crédito;0;1;0;1;
2022;2º;74118381;VOLVO ADMINISTRADORA DE CONSÓRCIO LTDA.;Descumprimento de cláusulas referentes à devolução de valores;0;2;0;2;
2022;2º;74118381;VOLVO ADMINISTRADORA DE CONSÓRCIO LTDA.;Descumprimento de obrigações previstas em contratos;0;1;0;1;
2022;2º;74118381;VOLVO ADMINISTRADORA DE CONSÓRCIO LTDA.;Descumprimento de prazo de resposta a demanda;0;1;0;1;
2022;2º;40011095;XS5 ADMINISTRADORA DE CONSÓRCIOS S.A.;Irregularidades relacionadas à liberação do crédito;0;1;0;1;
2022;2º;40011095;XS5 ADMINISTRADORA DE CONSÓRCIOS S.A.;Irregularidades relativas a integridade, confiabilidade, segurança, sigilo ou legitimidade das operações e serviços prestados relacionados a administradora de consórcio;1;0;0;1;
2022;2º;40011095;XS5 ADMINISTRADORA DE CONSÓRCIOS S.A.;Oferta ou prestação de informação a respeito de produtos e serviços de forma inadequada por administradora de consórcio;0;2;0;2;
2022;2º;47458153;YAMAHA ADMINISTRADORA DE CONSÓRCIO LTDA.;Descumprimento de cláusulas referentes à devolução de valores;0;3;0;3;
2022;2º;47458153;YAMAHA ADMINISTRADORA DE CONSÓRCIO LTDA.;Descumprimento de obrigações previstas em contratos;1;2;0;3;
2022;2º;47458153;YAMAHA ADMINISTRADORA DE CONSÓRCIO LTDA.;Insatisfação por parte do cliente com o atendimento prestado pela administradora de consórcio;0;0;1;1;
2022;2º;47458153;YAMAHA ADMINISTRADORA DE CONSÓRCIO LTDA.;Irregularidades relacionadas a informações e liquidação de valores a receber no sistema SVR do BCB por parte de consórcios;2;8;0;10;
2022;2º;47458153;YAMAHA ADMINISTRADORA DE CONSÓRCIO LTDA.;Irregularidades relacionadas à liberação do crédito;0;8;0;8;
2022;2º;47458153;YAMAHA ADMINISTRADORA DE CONSÓRCIO LTDA.;Irregularidades relativas a integridade, confiabilidade, segurança, sigilo ou legitimidade das operações e serviços prestados relacionados a administradora de consórcio;9;3;0;12;
2022;2º;47458153;YAMAHA ADMINISTRADORA DE CONSÓRCIO LTDA.;Não fornecimento, remessa ou divulgação de documentos por parte de administradora de consórcio;2;0;0;2;
2022;2º;47458153;YAMAHA ADMINISTRADORA DE CONSÓRCIO LTDA.;Outras irregularidades relacionadas à Ouvidoria;1;0;0;1;
2022;2º;47458153;YAMAHA ADMINISTRADORA DE CONSÓRCIO LTDA.;Reclamações relacionadas a assuntos diversos;0;0;2;2;
2022;2º;23367634;ZEMA ADMINISTRADORA DE CONSÓRCIO LTDA;Descumprimento de cláusulas referentes à devolução de valores;0;3;0;3;
2022;2º;23367634;ZEMA ADMINISTRADORA DE CONSÓRCIO LTDA;Descumprimento de obrigações previstas em contratos;1;0;0;1;
2022;2º;23367634;ZEMA ADMINISTRADORA DE CONSÓRCIO LTDA;Insatisfação com a resposta fornecida pela administradora de consórcio relativa à demanda registrada contra ela;1;3;0;4;
2022;2º;23367634;ZEMA ADMINISTRADORA DE CONSÓRCIO LTDA;Irregularidades relacionadas a informações e liquidação de valores a receber no sistema SVR do BCB por parte de consórcios;5;1;0;6;
2022;2º;23367634;ZEMA ADMINISTRADORA DE CONSÓRCIO LTDA;Irregularidades relacionadas às condições para contemplação por lance ou sorteio;0;1;0;1;
2022;2º;23367634;ZEMA ADMINISTRADORA DE CONSÓRCIO LTDA;Irregularidades relativas a integridade, confiabilidade, segurança, sigilo ou legitimidade das operações e serviços prestados relacionados a administradora de consórcio;0;1;0;1;
2022;2º;23367634;ZEMA ADMINISTRADORA DE CONSÓRCIO LTDA;Oferta ou prestação de informação a respeito de produtos e serviços de forma inadequada por administradora de consórcio;15;2;0;17;
