Ano;Semestre;CNPJ AC;Administradora de consórcio;Irregularidade;Quantidade de reclamações reguladas procedentes;Quantidade de reclamações reguladas - outras;Quantidade de reclamações não reguladas;Quantidade total de reclamações;
2022;1º;84911098;ADEMICON ADMINISTRADORA DE CONSÓRCIOS S.A.;Ausência de transparência nas relações contratuais;0;0;1;1;
2022;1º;84911098;ADEMICON ADMINISTRADORA DE CONSÓRCIOS S.A.;Falhas operacionais nos processos ou no sistema da Administradora;2;0;0;2;
2022;1º;84911098;ADEMICON ADMINISTRADORA DE CONSÓRCIOS S.A.;Irregularidades relacionadas a informações e liquidação de valores a receber no sistema SVR do BCB por parte de consórcios;0;1;0;1;
2022;1º;06044551;ADMINISTRADORA DE CONSORCIO NACIONAL GAZIN LTDA;Irregularidades relacionadas à liberação do crédito;0;1;0;1;
2022;1º;45441789;ADMINISTRADORA DE CONSORCIO NACIONAL HONDA LTDA;Ausência de prestação de informações sobre as regras de funcionamento do consórcio;2;1;0;3;
2022;1º;45441789;ADMINISTRADORA DE CONSORCIO NACIONAL HONDA LTDA;Descumprimento de cláusulas referentes à devolução de valores;1;11;0;12;
2022;1º;45441789;ADMINISTRADORA DE CONSORCIO NACIONAL HONDA LTDA;Descumprimento de obrigações previstas em contratos;0;4;0;4;
2022;1º;45441789;ADMINISTRADORA DE CONSORCIO NACIONAL HONDA LTDA;Falhas operacionais nos processos ou no sistema da Administradora;14;8;0;22;
2022;1º;45441789;ADMINISTRADORA DE CONSORCIO NACIONAL HONDA LTDA;Insatisfação com a resposta fornecida pela administradora de consórcio relativa à demanda registrada contra ela;0;3;0;3;
2022;1º;45441789;ADMINISTRADORA DE CONSORCIO NACIONAL HONDA LTDA;Irregularidades relacionadas a informações e liquidação de valores a receber no sistema SVR do BCB por parte de consórcios;0;85;0;85;
2022;1º;45441789;ADMINISTRADORA DE CONSORCIO NACIONAL HONDA LTDA;Irregularidades relacionadas à liberação do crédito;0;13;0;13;
2022;1º;45441789;ADMINISTRADORA DE CONSORCIO NACIONAL HONDA LTDA;Irregularidades relacionadas às condições para contemplação por lance ou sorteio;0;1;0;1;
2022;1º;45441789;ADMINISTRADORA DE CONSORCIO NACIONAL HONDA LTDA;Não fornecimento, remessa ou divulgação de documentos obrigatórios;0;1;0;1;
2022;1º;45441789;ADMINISTRADORA DE CONSORCIO NACIONAL HONDA LTDA;Reclamações relacionadas a assuntos diversos;0;0;6;6;
2022;1º;07808907;ADMINISTRADORA DE CONSORCIOS SICREDI LTDA;Ausência de prestação de informações sobre as regras de funcionamento do consórcio;2;0;0;2;
2022;1º;07808907;ADMINISTRADORA DE CONSORCIOS SICREDI LTDA;Descumprimento de cláusulas referentes à devolução de valores;1;0;0;1;
2022;1º;07808907;ADMINISTRADORA DE CONSORCIOS SICREDI LTDA;Descumprimento de obrigações previstas em contratos;1;0;0;1;
2022;1º;07808907;ADMINISTRADORA DE CONSORCIOS SICREDI LTDA;Falhas operacionais nos processos ou no sistema da Administradora;2;0;0;2;
2022;1º;07808907;ADMINISTRADORA DE CONSORCIOS SICREDI LTDA;Insatisfação com a resposta fornecida pela administradora de consórcio relativa à demanda registrada contra ela;1;1;0;2;
2022;1º;07808907;ADMINISTRADORA DE CONSORCIOS SICREDI LTDA;Irregularidades relacionadas a informações e liquidação de valores a receber no sistema SVR do BCB por parte de consórcios;0;1;0;1;
2022;1º;07808907;ADMINISTRADORA DE CONSORCIOS SICREDI LTDA;Irregularidades relacionadas à liberação do crédito;0;1;0;1;
2022;1º;03765340;ADMINISTRADORA DE CONSÓRCIO NACIONAL VALOR S.A.;Ausência de prestação de informações sobre as regras de funcionamento do consórcio;1;0;0;1;
2022;1º;73230674;ADMINISTRADORA DE CONSÓRCIO RCI BRASIL LTDA;Descumprimento de cláusulas referentes à devolução de valores;0;3;0;3;
2022;1º;73230674;ADMINISTRADORA DE CONSÓRCIO RCI BRASIL LTDA;Descumprimento de obrigações previstas em contratos;0;1;0;1;
2022;1º;73230674;ADMINISTRADORA DE CONSÓRCIO RCI BRASIL LTDA;Falhas operacionais nos processos ou no sistema da Administradora;0;1;0;1;
2022;1º;73230674;ADMINISTRADORA DE CONSÓRCIO RCI BRASIL LTDA;Insatisfação com a resposta fornecida pela administradora de consórcio relativa à demanda registrada contra ela;0;1;0;1;
2022;1º;73230674;ADMINISTRADORA DE CONSÓRCIO RCI BRASIL LTDA;Irregularidades relacionadas à liberação do crédito;0;3;0;3;
2022;1º;73230674;ADMINISTRADORA DE CONSÓRCIO RCI BRASIL LTDA;Reclamações relacionadas a assuntos diversos;0;0;1;1;
2022;1º;12228808;ADMINISTRADORA DE CONSÓRCIO UNICOOB LTDA;Descumprimento de obrigações previstas em contratos;0;1;0;1;
2022;1º;12228808;ADMINISTRADORA DE CONSÓRCIO UNICOOB LTDA;Falhas operacionais nos processos ou no sistema da Administradora;2;1;0;3;
2022;1º;12228808;ADMINISTRADORA DE CONSÓRCIO UNICOOB LTDA;Irregularidades relacionadas à liberação do crédito;0;1;0;1;
2022;1º;94187879;AGIBANK ADMINISTRADORA DE CONSÓRCIOS LTDA;Ausência de prestação de informações sobre as regras de funcionamento do consórcio;0;1;0;1;
2022;1º;94187879;AGIBANK ADMINISTRADORA DE CONSÓRCIOS LTDA;Descumprimento de cláusulas referentes à devolução de valores;0;1;0;1;
2022;1º;94187879;AGIBANK ADMINISTRADORA DE CONSÓRCIOS LTDA;Descumprimento de obrigações previstas em contratos;0;1;0;1;
2022;1º;94187879;AGIBANK ADMINISTRADORA DE CONSÓRCIOS LTDA;Falhas operacionais nos processos ou no sistema da Administradora;2;0;0;2;
2022;1º;94187879;AGIBANK ADMINISTRADORA DE CONSÓRCIOS LTDA;Não fornecimento, remessa ou divulgação de documentos obrigatórios;1;0;0;1;
2022;1º;90982679;ALPHA ADMINISTRADORA DE CONSÓRCIO LTDA.;Ausência de prestação de informações sobre as regras de funcionamento do consórcio;2;0;0;2;
2022;1º;60375243;ANCORA ADMINISTRADORA DE CONSORCIOS S.A.;Ausência de prestação de informações sobre as regras de funcionamento do consórcio;1;1;0;2;
2022;1º;60375243;ANCORA ADMINISTRADORA DE CONSORCIOS S.A.;Descumprimento de obrigações previstas em contratos;0;1;0;1;
2022;1º;60375243;ANCORA ADMINISTRADORA DE CONSORCIOS S.A.;Falhas operacionais nos processos ou no sistema da Administradora;4;0;0;4;
2022;1º;21275235;ATUAL ADMINISTRADORA DE CONSÓRCIO LTDA.;Descumprimento de prazo de resposta a demanda;1;0;0;1;
2022;1º;71045363;BAMAQ ADMINISTRADORA DE CONSÓRCIOS LTDA;Descumprimento de obrigações previstas em contratos;1;0;0;1;
2022;1º;71045363;BAMAQ ADMINISTRADORA DE CONSÓRCIOS LTDA;Falhas operacionais nos processos ou no sistema da Administradora;2;0;0;2;
2022;1º;71045363;BAMAQ ADMINISTRADORA DE CONSÓRCIOS LTDA;Irregularidades relacionadas à liberação do crédito;0;1;0;1;
2022;1º;02010478;BANCORBRÁS ADMINISTRADORA DE CONSÓRCIOS S.A.;Descumprimento de cláusulas referentes à devolução de valores;0;2;0;2;
2022;1º;02010478;BANCORBRÁS ADMINISTRADORA DE CONSÓRCIOS S.A.;Descumprimento de obrigações previstas em contratos;0;1;0;1;
2022;1º;02010478;BANCORBRÁS ADMINISTRADORA DE CONSÓRCIOS S.A.;Falhas operacionais nos processos ou no sistema da Administradora;1;0;0;1;
2022;1º;02010478;BANCORBRÁS ADMINISTRADORA DE CONSÓRCIOS S.A.;Insatisfação com a resposta fornecida pela administradora de consórcio relativa à demanda registrada contra ela;0;1;0;1;
2022;1º;02010478;BANCORBRÁS ADMINISTRADORA DE CONSÓRCIOS S.A.;Irregularidades relacionadas a informações e liquidação de valores a receber no sistema SVR do BCB por parte de consórcios;0;4;0;4;
2022;1º;02010478;BANCORBRÁS ADMINISTRADORA DE CONSÓRCIOS S.A.;Irregularidades relacionadas às condições para contemplação por lance ou sorteio;0;1;0;1;
2022;1º;92692979;BANRISUL S.A. - ADMINISTRADORA DE CONSÓRCIOS;Insatisfação por parte do cliente com o atendimento prestado pela administradora de consórcio;0;0;1;1;
2022;1º;92692979;BANRISUL S.A. - ADMINISTRADORA DE CONSÓRCIOS;Irregularidades relacionadas à liberação do crédito;1;1;0;2;
2022;1º;06043050;BB ADMINISTRADORA DE CONSORCIOS S.A.;Ausência de informações/cláusulas obrigatórias em contrato;0;1;0;1;
2022;1º;06043050;BB ADMINISTRADORA DE CONSORCIOS S.A.;Ausência de prestação de informações sobre as regras de funcionamento do consórcio;10;4;0;14;
2022;1º;06043050;BB ADMINISTRADORA DE CONSORCIOS S.A.;Descumprimento de cláusulas referentes à devolução de valores;2;11;0;13;
2022;1º;06043050;BB ADMINISTRADORA DE CONSORCIOS S.A.;Descumprimento de obrigações previstas em contratos;3;16;0;19;
2022;1º;06043050;BB ADMINISTRADORA DE CONSORCIOS S.A.;Descumprimento de prazo de resposta a demanda;0;1;0;1;
2022;1º;06043050;BB ADMINISTRADORA DE CONSORCIOS S.A.;Falhas operacionais nos processos ou no sistema da Administradora;54;30;0;84;
2022;1º;06043050;BB ADMINISTRADORA DE CONSORCIOS S.A.;Insatisfação com a resposta fornecida pela administradora de consórcio relativa à demanda registrada contra ela;2;8;0;10;
2022;1º;06043050;BB ADMINISTRADORA DE CONSORCIOS S.A.;Insatisfação por parte do cliente com o atendimento prestado pela administradora de consórcio;0;0;2;2;
2022;1º;06043050;BB ADMINISTRADORA DE CONSORCIOS S.A.;Irregularidades relacionadas a informações e liquidação de valores a receber no sistema SVR do BCB por parte de consórcios;1;10;0;11;
2022;1º;06043050;BB ADMINISTRADORA DE CONSORCIOS S.A.;Irregularidades relacionadas à liberação do crédito;9;26;0;35;
2022;1º;06043050;BB ADMINISTRADORA DE CONSORCIOS S.A.;Irregularidades relacionadas às condições para contemplação por lance ou sorteio;1;5;0;6;
2022;1º;06043050;BB ADMINISTRADORA DE CONSORCIOS S.A.;Não fornecimento, remessa ou divulgação de documentos obrigatórios;9;3;0;12;
2022;1º;06043050;BB ADMINISTRADORA DE CONSORCIOS S.A.;Reclamações relacionadas a assuntos diversos;0;0;8;8;
2022;1º;14723388;BR CONSÓRCIOS ADMINISTRADORA DE CONSÓRCIOS LTDA;Ausência de prestação de informações sobre as regras de funcionamento do consórcio;1;0;0;1;
2022;1º;14723388;BR CONSÓRCIOS ADMINISTRADORA DE CONSÓRCIOS LTDA;Descumprimento de cláusulas referentes à devolução de valores;0;5;0;5;
2022;1º;14723388;BR CONSÓRCIOS ADMINISTRADORA DE CONSÓRCIOS LTDA;Falhas operacionais nos processos ou no sistema da Administradora;1;2;0;3;
2022;1º;14723388;BR CONSÓRCIOS ADMINISTRADORA DE CONSÓRCIOS LTDA;Irregularidades relacionadas a informações e liquidação de valores a receber no sistema SVR do BCB por parte de consórcios;0;1;0;1;
2022;1º;14723388;BR CONSÓRCIOS ADMINISTRADORA DE CONSÓRCIOS LTDA;Não fornecimento, remessa ou divulgação de documentos obrigatórios;0;2;0;2;
2022;1º;14723388;BR CONSÓRCIOS ADMINISTRADORA DE CONSÓRCIOS LTDA;Reclamações relacionadas a assuntos diversos;0;0;1;1;
2022;1º;52568821;BRADESCO ADMINISTRADORA DE CONSÓRCIOS LTDA.;Ausência de prestação de informações sobre as regras de funcionamento do consórcio;4;3;0;7;
2022;1º;52568821;BRADESCO ADMINISTRADORA DE CONSÓRCIOS LTDA.;Ausência de transparência nas relações contratuais;0;0;2;2;
2022;1º;52568821;BRADESCO ADMINISTRADORA DE CONSÓRCIOS LTDA.;Cobrança irregular de tarifa pela emissão de boletos, carnês e assemelhados;0;2;0;2;
2022;1º;52568821;BRADESCO ADMINISTRADORA DE CONSÓRCIOS LTDA.;Descumprimento de cláusulas referentes à devolução de valores;4;47;0;51;
2022;1º;52568821;BRADESCO ADMINISTRADORA DE CONSÓRCIOS LTDA.;Descumprimento de obrigações previstas em contratos;4;24;0;28;
2022;1º;52568821;BRADESCO ADMINISTRADORA DE CONSÓRCIOS LTDA.;Descumprimento de prazo de resposta a demanda;0;4;0;4;
2022;1º;52568821;BRADESCO ADMINISTRADORA DE CONSÓRCIOS LTDA.;Falhas operacionais nos processos ou no sistema da Administradora;74;52;0;126;
2022;1º;52568821;BRADESCO ADMINISTRADORA DE CONSÓRCIOS LTDA.;Insatisfação com a resposta fornecida pela administradora de consórcio relativa à demanda registrada contra ela;1;22;0;23;
2022;1º;52568821;BRADESCO ADMINISTRADORA DE CONSÓRCIOS LTDA.;Insatisfação por parte do cliente com o atendimento prestado pela administradora de consórcio;0;0;6;6;
2022;1º;52568821;BRADESCO ADMINISTRADORA DE CONSÓRCIOS LTDA.;Irregularidades relacionadas a informações e liquidação de valores a receber no sistema SVR do BCB por parte de consórcios;3;30;0;33;
2022;1º;52568821;BRADESCO ADMINISTRADORA DE CONSÓRCIOS LTDA.;Irregularidades relacionadas à liberação do crédito;5;49;0;54;
2022;1º;52568821;BRADESCO ADMINISTRADORA DE CONSÓRCIOS LTDA.;Irregularidades relacionadas às condições para contemplação por lance ou sorteio;1;8;0;9;
2022;1º;52568821;BRADESCO ADMINISTRADORA DE CONSÓRCIOS LTDA.;Não fornecimento, remessa ou divulgação de documentos obrigatórios;11;11;0;22;
2022;1º;52568821;BRADESCO ADMINISTRADORA DE CONSÓRCIOS LTDA.;Outras irregularidades;0;1;0;1;
2022;1º;52568821;BRADESCO ADMINISTRADORA DE CONSÓRCIOS LTDA.;Outras irregularidades relacionadas à Ouvidoria;0;1;0;1;
2022;1º;52568821;BRADESCO ADMINISTRADORA DE CONSÓRCIOS LTDA.;Reclamações relacionadas a assuntos diversos;0;0;7;7;
2022;1º;73235962;BREITKOPF ADMINISTRADORA DE CONSÓRCIO LTDA.;Falhas operacionais nos processos ou no sistema da Administradora;1;0;0;1;
2022;1º;45713971;BRQUALY ADMINISTRADORA DE CONSÓRCIOS LTDA.;Falhas operacionais nos processos ou no sistema da Administradora;1;0;0;1;
2022;1º;45713971;BRQUALY ADMINISTRADORA DE CONSÓRCIOS LTDA.;Irregularidades relacionadas à liberação do crédito;0;2;0;2;
2022;1º;45713971;BRQUALY ADMINISTRADORA DE CONSÓRCIOS LTDA.;Reclamações relacionadas a assuntos diversos;0;0;1;1;
2022;1º;72461643;CAMVEL ADMINISTRADORA DE CONSÓRCIOS LTDA.;Irregularidades relacionadas a informações e liquidação de valores a receber no sistema SVR do BCB por parte de consórcios;1;0;0;1;
2022;1º;68318773;CANOPUS ADMINISTRADORA DE CONSORCIOS S/A;Ausência de prestação de informações sobre as regras de funcionamento do consórcio;0;3;0;3;
2022;1º;68318773;CANOPUS ADMINISTRADORA DE CONSORCIOS S/A;Descumprimento de cláusulas referentes à devolução de valores;0;3;0;3;
2022;1º;68318773;CANOPUS ADMINISTRADORA DE CONSORCIOS S/A;Insatisfação com a resposta fornecida pela administradora de consórcio relativa à demanda registrada contra ela;0;1;0;1;
2022;1º;68318773;CANOPUS ADMINISTRADORA DE CONSORCIOS S/A;Insatisfação por parte do cliente com o atendimento prestado pela administradora de consórcio;0;0;1;1;
2022;1º;68318773;CANOPUS ADMINISTRADORA DE CONSORCIOS S/A;Irregularidades relacionadas à liberação do crédito;0;1;0;1;
2022;1º;13170428;CIMAVEL ADMINISTRADORA DE CONSÓRCIO LTDA.;Outras irregularidades;0;1;0;1;
2022;1º;59129403;CNF - ADMINISTRADORA DE CONSÓRCIOS NACIONAL LTDA.;Ausência de prestação de informações sobre as regras de funcionamento do consórcio;0;1;0;1;
2022;1º;59129403;CNF - ADMINISTRADORA DE CONSÓRCIOS NACIONAL LTDA.;Descumprimento de cláusulas referentes à devolução de valores;0;2;0;2;
2022;1º;59129403;CNF - ADMINISTRADORA DE CONSÓRCIOS NACIONAL LTDA.;Descumprimento de obrigações previstas em contratos;0;1;0;1;
2022;1º;59129403;CNF - ADMINISTRADORA DE CONSÓRCIOS NACIONAL LTDA.;Falhas operacionais nos processos ou no sistema da Administradora;0;1;0;1;
2022;1º;59129403;CNF - ADMINISTRADORA DE CONSÓRCIOS NACIONAL LTDA.;Irregularidades relacionadas a informações e liquidação de valores a receber no sistema SVR do BCB por parte de consórcios;0;1;0;1;
2022;1º;62798475;CNK ADMINISTRADORA DE CONSÓRCIO LTDA.;Ausência de prestação de informações sobre as regras de funcionamento do consórcio;45;6;0;51;
2022;1º;62798475;CNK ADMINISTRADORA DE CONSÓRCIO LTDA.;Descumprimento de cláusulas referentes à devolução de valores;0;3;0;3;
2022;1º;62798475;CNK ADMINISTRADORA DE CONSÓRCIO LTDA.;Falhas operacionais nos processos ou no sistema da Administradora;3;1;0;4;
2022;1º;62798475;CNK ADMINISTRADORA DE CONSÓRCIO LTDA.;Insatisfação com a resposta fornecida pela administradora de consórcio relativa à demanda registrada contra ela;0;11;0;11;
2022;1º;62798475;CNK ADMINISTRADORA DE CONSÓRCIO LTDA.;Irregularidades relacionadas às condições para contemplação por lance ou sorteio;0;1;0;1;
2022;1º;62798475;CNK ADMINISTRADORA DE CONSÓRCIO LTDA.;Outras irregularidades relacionadas à Ouvidoria;0;1;0;1;
2022;1º;05349595;CNP CONSÓRCIO S.A. ADMINISTRADORA DE CONSÓRCIOS;Ausência de prestação de informações sobre as regras de funcionamento do consórcio;18;5;0;23;
2022;1º;05349595;CNP CONSÓRCIO S.A. ADMINISTRADORA DE CONSÓRCIOS;Descumprimento de cláusulas referentes à devolução de valores;2;9;0;11;
2022;1º;05349595;CNP CONSÓRCIO S.A. ADMINISTRADORA DE CONSÓRCIOS;Descumprimento de obrigações previstas em contratos;2;6;0;8;
2022;1º;05349595;CNP CONSÓRCIO S.A. ADMINISTRADORA DE CONSÓRCIOS;Descumprimento de prazo de resposta a demanda;1;0;0;1;
2022;1º;05349595;CNP CONSÓRCIO S.A. ADMINISTRADORA DE CONSÓRCIOS;Falhas operacionais nos processos ou no sistema da Administradora;38;13;0;51;
2022;1º;05349595;CNP CONSÓRCIO S.A. ADMINISTRADORA DE CONSÓRCIOS;Insatisfação com a resposta fornecida pela administradora de consórcio relativa à demanda registrada contra ela;0;3;0;3;
2022;1º;05349595;CNP CONSÓRCIO S.A. ADMINISTRADORA DE CONSÓRCIOS;Insatisfação por parte do cliente com o atendimento prestado pela administradora de consórcio;0;0;7;7;
2022;1º;05349595;CNP CONSÓRCIO S.A. ADMINISTRADORA DE CONSÓRCIOS;Irregularidades relacionadas a informações e liquidação de valores a receber no sistema SVR do BCB por parte de consórcios;2;17;0;19;
2022;1º;05349595;CNP CONSÓRCIO S.A. ADMINISTRADORA DE CONSÓRCIOS;Irregularidades relacionadas à liberação do crédito;4;18;0;22;
2022;1º;05349595;CNP CONSÓRCIO S.A. ADMINISTRADORA DE CONSÓRCIOS;Irregularidades relacionadas às condições para contemplação por lance ou sorteio;0;2;0;2;
2022;1º;05349595;CNP CONSÓRCIO S.A. ADMINISTRADORA DE CONSÓRCIOS;Não fornecimento, remessa ou divulgação de documentos obrigatórios;3;5;0;8;
2022;1º;05349595;CNP CONSÓRCIO S.A. ADMINISTRADORA DE CONSÓRCIOS;Reclamações relacionadas a assuntos diversos;0;0;3;3;
2022;1º;27268770;COIMEX ADMINISTRADORA DE CONSÓRCIOS S.A.;Ausência de prestação de informações sobre as regras de funcionamento do consórcio;1;0;0;1;
2022;1º;27268770;COIMEX ADMINISTRADORA DE CONSÓRCIOS S.A.;Descumprimento de obrigações previstas em contratos;1;2;0;3;
2022;1º;27268770;COIMEX ADMINISTRADORA DE CONSÓRCIOS S.A.;Falhas operacionais nos processos ou no sistema da Administradora;2;2;0;4;
2022;1º;27268770;COIMEX ADMINISTRADORA DE CONSÓRCIOS S.A.;Insatisfação com a resposta fornecida pela administradora de consórcio relativa à demanda registrada contra ela;0;1;0;1;
2022;1º;27268770;COIMEX ADMINISTRADORA DE CONSÓRCIOS S.A.;Irregularidades relacionadas a informações e liquidação de valores a receber no sistema SVR do BCB por parte de consórcios;0;7;0;7;
2022;1º;27268770;COIMEX ADMINISTRADORA DE CONSÓRCIOS S.A.;Irregularidades relacionadas à liberação do crédito;0;1;0;1;
2022;1º;27268770;COIMEX ADMINISTRADORA DE CONSÓRCIOS S.A.;Irregularidades relacionadas às condições para contemplação por lance ou sorteio;0;1;0;1;
2022;1º;27268770;COIMEX ADMINISTRADORA DE CONSÓRCIOS S.A.;Não fornecimento, remessa ou divulgação de documentos obrigatórios;1;0;0;1;
2022;1º;44474674;COMAUTO ADMINISTRADORA DE CONSORCIO LTDA;Irregularidades relacionadas à liberação do crédito;0;1;0;1;
2022;1º;44196293;CONSHOP ADMINISTRADORA DE CONSORCIOS LTDA.;Descumprimento de cláusulas referentes à devolução de valores;1;0;0;1;
2022;1º;44196293;CONSHOP ADMINISTRADORA DE CONSORCIOS LTDA.;Descumprimento de obrigações previstas em contratos;1;0;0;1;
2022;1º;44196293;CONSHOP ADMINISTRADORA DE CONSORCIOS LTDA.;Falhas operacionais nos processos ou no sistema da Administradora;3;0;0;3;
2022;1º;44196293;CONSHOP ADMINISTRADORA DE CONSORCIOS LTDA.;Insatisfação por parte do cliente com o atendimento prestado pela administradora de consórcio;0;0;1;1;
2022;1º;44196293;CONSHOP ADMINISTRADORA DE CONSORCIOS LTDA.;Irregularidades relacionadas a informações e liquidação de valores a receber no sistema SVR do BCB por parte de consórcios;0;1;0;1;
2022;1º;47658539;CONSÓRCIO NACIONAL VOLKSWAGEN - ADMINISTRADORA DE CONSÓRCIO LTDA.;Ausência de prestação de informações sobre as regras de funcionamento do consórcio;0;1;0;1;
2022;1º;47658539;CONSÓRCIO NACIONAL VOLKSWAGEN - ADMINISTRADORA DE CONSÓRCIO LTDA.;Descumprimento de cláusulas referentes à devolução de valores;2;4;0;6;
2022;1º;47658539;CONSÓRCIO NACIONAL VOLKSWAGEN - ADMINISTRADORA DE CONSÓRCIO LTDA.;Descumprimento de obrigações previstas em contratos;1;4;0;5;
2022;1º;47658539;CONSÓRCIO NACIONAL VOLKSWAGEN - ADMINISTRADORA DE CONSÓRCIO LTDA.;Falhas operacionais nos processos ou no sistema da Administradora;6;6;0;12;
2022;1º;47658539;CONSÓRCIO NACIONAL VOLKSWAGEN - ADMINISTRADORA DE CONSÓRCIO LTDA.;Insatisfação com a resposta fornecida pela administradora de consórcio relativa à demanda registrada contra ela;0;1;0;1;
2022;1º;47658539;CONSÓRCIO NACIONAL VOLKSWAGEN - ADMINISTRADORA DE CONSÓRCIO LTDA.;Insatisfação por parte do cliente com o atendimento prestado pela administradora de consórcio;0;0;6;6;
2022;1º;47658539;CONSÓRCIO NACIONAL VOLKSWAGEN - ADMINISTRADORA DE CONSÓRCIO LTDA.;Irregularidades relacionadas a informações e liquidação de valores a receber no sistema SVR do BCB por parte de consórcios;0;19;0;19;
2022;1º;47658539;CONSÓRCIO NACIONAL VOLKSWAGEN - ADMINISTRADORA DE CONSÓRCIO LTDA.;Irregularidades relacionadas à liberação do crédito;1;5;0;6;
2022;1º;47658539;CONSÓRCIO NACIONAL VOLKSWAGEN - ADMINISTRADORA DE CONSÓRCIO LTDA.;Irregularidades relacionadas às condições para contemplação por lance ou sorteio;0;2;0;2;
2022;1º;47658539;CONSÓRCIO NACIONAL VOLKSWAGEN - ADMINISTRADORA DE CONSÓRCIO LTDA.;Não fornecimento, remessa ou divulgação de documentos obrigatórios;1;0;0;1;
2022;1º;47658539;CONSÓRCIO NACIONAL VOLKSWAGEN - ADMINISTRADORA DE CONSÓRCIO LTDA.;Reclamações relacionadas a assuntos diversos;0;0;2;2;
2022;1º;58919903;CONVEF ADMINISTRADORA DE CONSÓRCIOS LTDA.;Ausência de prestação de informações sobre as regras de funcionamento do consórcio;2;0;0;2;
2022;1º;58919903;CONVEF ADMINISTRADORA DE CONSÓRCIOS LTDA.;Descumprimento de cláusulas referentes à devolução de valores;0;1;0;1;
2022;1º;58919903;CONVEF ADMINISTRADORA DE CONSÓRCIOS LTDA.;Descumprimento de obrigações previstas em contratos;2;1;0;3;
2022;1º;58919903;CONVEF ADMINISTRADORA DE CONSÓRCIOS LTDA.;Insatisfação por parte do cliente com o atendimento prestado pela administradora de consórcio;0;0;1;1;
2022;1º;58919903;CONVEF ADMINISTRADORA DE CONSÓRCIOS LTDA.;Irregularidades relacionadas a informações e liquidação de valores a receber no sistema SVR do BCB por parte de consórcios;0;3;0;3;
2022;1º;58919903;CONVEF ADMINISTRADORA DE CONSÓRCIOS LTDA.;Não fornecimento, remessa ou divulgação de documentos obrigatórios;0;1;0;1;
2022;1º;58919903;CONVEF ADMINISTRADORA DE CONSÓRCIOS LTDA.;Outras irregularidades;1;0;0;1;
2022;1º;61550836;COOPERATIVA MISTA JOCKEY CLUB DE SAO PAULO;Ausência de prestação de informações sobre as regras de funcionamento do consórcio;16;8;0;24;
2022;1º;61550836;COOPERATIVA MISTA JOCKEY CLUB DE SAO PAULO;Ausência de transparência nas relações contratuais;0;0;1;1;
2022;1º;61550836;COOPERATIVA MISTA JOCKEY CLUB DE SAO PAULO;Descumprimento de cláusulas referentes à devolução de valores;1;1;0;2;
2022;1º;61550836;COOPERATIVA MISTA JOCKEY CLUB DE SAO PAULO;Falhas operacionais nos processos ou no sistema da Administradora;1;1;0;2;
2022;1º;61550836;COOPERATIVA MISTA JOCKEY CLUB DE SAO PAULO;Insatisfação com a resposta fornecida pela administradora de consórcio relativa à demanda registrada contra ela;0;2;0;2;
2022;1º;61550836;COOPERATIVA MISTA JOCKEY CLUB DE SAO PAULO;Irregularidades relacionadas à liberação do crédito;0;2;0;2;
2022;1º;59395061;DISAL ADMINISTRADORA DE CONSÓRCIOS LTDA;Ausência de prestação de informações sobre as regras de funcionamento do consórcio;5;2;0;7;
2022;1º;59395061;DISAL ADMINISTRADORA DE CONSÓRCIOS LTDA;Descumprimento de cláusulas referentes à devolução de valores;0;11;0;11;
2022;1º;59395061;DISAL ADMINISTRADORA DE CONSÓRCIOS LTDA;Descumprimento de obrigações previstas em contratos;1;5;0;6;
2022;1º;59395061;DISAL ADMINISTRADORA DE CONSÓRCIOS LTDA;Descumprimento de prazo de resposta a demanda;1;1;0;2;
2022;1º;59395061;DISAL ADMINISTRADORA DE CONSÓRCIOS LTDA;Falhas operacionais nos processos ou no sistema da Administradora;17;9;0;26;
2022;1º;59395061;DISAL ADMINISTRADORA DE CONSÓRCIOS LTDA;Insatisfação com a resposta fornecida pela administradora de consórcio relativa à demanda registrada contra ela;2;6;0;8;
2022;1º;59395061;DISAL ADMINISTRADORA DE CONSÓRCIOS LTDA;Insatisfação por parte do cliente com o atendimento prestado pela administradora de consórcio;0;0;3;3;
2022;1º;59395061;DISAL ADMINISTRADORA DE CONSÓRCIOS LTDA;Irregularidades relacionadas a informações e liquidação de valores a receber no sistema SVR do BCB por parte de consórcios;0;10;0;10;
2022;1º;59395061;DISAL ADMINISTRADORA DE CONSÓRCIOS LTDA;Irregularidades relacionadas à liberação do crédito;2;5;0;7;
2022;1º;59395061;DISAL ADMINISTRADORA DE CONSÓRCIOS LTDA;Irregularidades relacionadas às condições para contemplação por lance ou sorteio;0;1;0;1;
2022;1º;59395061;DISAL ADMINISTRADORA DE CONSÓRCIOS LTDA;Não fornecimento, remessa ou divulgação de documentos obrigatórios;2;5;0;7;
2022;1º;59395061;DISAL ADMINISTRADORA DE CONSÓRCIOS LTDA;Reclamações relacionadas a assuntos diversos;0;0;1;1;
2022;1º;01659838;DISBRAVE ADMINISTRADORA DE CONSORCIOS LTDA.;Descumprimento de cláusulas referentes à devolução de valores;0;1;0;1;
2022;1º;01659838;DISBRAVE ADMINISTRADORA DE CONSORCIOS LTDA.;Descumprimento de obrigações previstas em contratos;0;2;0;2;
2022;1º;01659838;DISBRAVE ADMINISTRADORA DE CONSORCIOS LTDA.;Falhas operacionais nos processos ou no sistema da Administradora;0;1;0;1;
2022;1º;01659838;DISBRAVE ADMINISTRADORA DE CONSORCIOS LTDA.;Insatisfação com a resposta fornecida pela administradora de consórcio relativa à demanda registrada contra ela;0;1;0;1;
2022;1º;01659838;DISBRAVE ADMINISTRADORA DE CONSORCIOS LTDA.;Irregularidades relacionadas às condições para contemplação por lance ou sorteio;0;1;0;1;
2022;1º;01659838;DISBRAVE ADMINISTRADORA DE CONSORCIOS LTDA.;Reclamações relacionadas a assuntos diversos;0;0;1;1;
2022;1º;08570707;ELDORADO ADMINISTRADORA DE CONSORCIO LTDA;Irregularidades relacionadas a informações e liquidação de valores a receber no sistema SVR do BCB por parte de consórcios;0;1;0;1;
2022;1º;58113812;EMBRACON ADMINISTRADORA DE CONSÓRCIO LTDA;Ausência de prestação de informações sobre as regras de funcionamento do consórcio;13;6;0;19;
2022;1º;58113812;EMBRACON ADMINISTRADORA DE CONSÓRCIO LTDA;Ausência de transparência nas relações contratuais;0;0;1;1;
2022;1º;58113812;EMBRACON ADMINISTRADORA DE CONSÓRCIO LTDA;Cobrança irregular de tarifa pela emissão de boletos, carnês e assemelhados;0;1;0;1;
2022;1º;58113812;EMBRACON ADMINISTRADORA DE CONSÓRCIO LTDA;Descumprimento de cláusulas referentes à devolução de valores;0;20;0;20;
2022;1º;58113812;EMBRACON ADMINISTRADORA DE CONSÓRCIO LTDA;Descumprimento de obrigações previstas em contratos;0;5;0;5;
2022;1º;58113812;EMBRACON ADMINISTRADORA DE CONSÓRCIO LTDA;Falhas operacionais nos processos ou no sistema da Administradora;12;14;0;26;
2022;1º;58113812;EMBRACON ADMINISTRADORA DE CONSÓRCIO LTDA;Insatisfação com a resposta fornecida pela administradora de consórcio relativa à demanda registrada contra ela;0;3;0;3;
2022;1º;58113812;EMBRACON ADMINISTRADORA DE CONSÓRCIO LTDA;Insatisfação por parte do cliente com o atendimento prestado pela administradora de consórcio;0;0;2;2;
2022;1º;58113812;EMBRACON ADMINISTRADORA DE CONSÓRCIO LTDA;Irregularidades relacionadas a informações e liquidação de valores a receber no sistema SVR do BCB por parte de consórcios;0;11;0;11;
2022;1º;58113812;EMBRACON ADMINISTRADORA DE CONSÓRCIO LTDA;Irregularidades relacionadas à liberação do crédito;0;21;0;21;
2022;1º;58113812;EMBRACON ADMINISTRADORA DE CONSÓRCIO LTDA;Irregularidades relacionadas às condições para contemplação por lance ou sorteio;0;3;0;3;
2022;1º;58113812;EMBRACON ADMINISTRADORA DE CONSÓRCIO LTDA;Não fornecimento, remessa ou divulgação de documentos obrigatórios;0;2;0;2;
2022;1º;58113812;EMBRACON ADMINISTRADORA DE CONSÓRCIO LTDA;Reclamações relacionadas a assuntos diversos;0;0;3;3;
2022;1º;91107581;FARROUPILHA ADMINISTRADORA DE CONSÓRCIOS LTDA.;Descumprimento de obrigações previstas em contratos;0;1;0;1;
2022;1º;91107581;FARROUPILHA ADMINISTRADORA DE CONSÓRCIOS LTDA.;Falhas operacionais nos processos ou no sistema da Administradora;1;0;0;1;
2022;1º;91107581;FARROUPILHA ADMINISTRADORA DE CONSÓRCIOS LTDA.;Insatisfação por parte do cliente com o atendimento prestado pela administradora de consórcio;0;0;1;1;
2022;1º;91107581;FARROUPILHA ADMINISTRADORA DE CONSÓRCIOS LTDA.;Irregularidades relacionadas a informações e liquidação de valores a receber no sistema SVR do BCB por parte de consórcios;2;4;0;6;
2022;1º;78688462;FIPAL ADMINISTRADORA DE CONSÓRCIOS LTDA;Falhas operacionais nos processos ou no sistema da Administradora;1;0;0;1;
2022;1º;00643742;FUNDACAO HABITACIONAL DO EXERCITO - FHE;Irregularidades relacionadas a informações e liquidação de valores a receber no sistema SVR do BCB por parte de consórcios;0;1;0;1;
2022;1º;49937055;GMAC ADMINISTRADORA DE CONSORCIOS LTDA;Ausência de prestação de informações sobre as regras de funcionamento do consórcio;4;3;0;7;
2022;1º;49937055;GMAC ADMINISTRADORA DE CONSORCIOS LTDA;Descumprimento de cláusulas referentes à devolução de valores;0;2;0;2;
2022;1º;49937055;GMAC ADMINISTRADORA DE CONSORCIOS LTDA;Descumprimento de obrigações previstas em contratos;0;4;0;4;
2022;1º;49937055;GMAC ADMINISTRADORA DE CONSORCIOS LTDA;Falhas operacionais nos processos ou no sistema da Administradora;22;7;0;29;
2022;1º;49937055;GMAC ADMINISTRADORA DE CONSORCIOS LTDA;Insatisfação com a resposta fornecida pela administradora de consórcio relativa à demanda registrada contra ela;0;5;0;5;
2022;1º;49937055;GMAC ADMINISTRADORA DE CONSORCIOS LTDA;Irregularidades relacionadas a informações e liquidação de valores a receber no sistema SVR do BCB por parte de consórcios;2;55;0;57;
2022;1º;49937055;GMAC ADMINISTRADORA DE CONSORCIOS LTDA;Irregularidades relacionadas à liberação do crédito;0;17;0;17;
2022;1º;49937055;GMAC ADMINISTRADORA DE CONSORCIOS LTDA;Não fornecimento, remessa ou divulgação de documentos obrigatórios;2;1;0;3;
2022;1º;49937055;GMAC ADMINISTRADORA DE CONSORCIOS LTDA;Reclamações relacionadas a assuntos diversos;0;0;1;1;
2022;1º;91338228;GRAVEL ADMINISTRADORA DE CONSÓRCIOS LTDA.;Irregularidades relacionadas a informações e liquidação de valores a receber no sistema SVR do BCB por parte de consórcios;0;1;0;1;
2022;1º;26228270;GROSCON ADMINISTRADORA DE CONSORCIOS LTDA.;Ausência de prestação de informações sobre as regras de funcionamento do consórcio;0;2;0;2;
2022;1º;03586655;H. ADMINISTRADORA DE CONSÓRCIOS LTDA;Descumprimento de obrigações previstas em contratos;1;0;0;1;
2022;1º;73516106;HS ADMINISTRADORA DE CONSÓRCIOS LTDA;Ausência de transparência nas relações contratuais;0;0;1;1;
2022;1º;73516106;HS ADMINISTRADORA DE CONSÓRCIOS LTDA;Descumprimento de cláusulas referentes à devolução de valores;0;1;0;1;
2022;1º;73516106;HS ADMINISTRADORA DE CONSÓRCIOS LTDA;Descumprimento de obrigações previstas em contratos;0;1;0;1;
2022;1º;73516106;HS ADMINISTRADORA DE CONSÓRCIOS LTDA;Falhas operacionais nos processos ou no sistema da Administradora;2;0;0;2;
2022;1º;73516106;HS ADMINISTRADORA DE CONSÓRCIOS LTDA;Insatisfação com a resposta fornecida pela administradora de consórcio relativa à demanda registrada contra ela;0;1;0;1;
2022;1º;73516106;HS ADMINISTRADORA DE CONSÓRCIOS LTDA;Irregularidades relacionadas à liberação do crédito;0;3;0;3;
2022;1º;00000776;ITAÚ ADMINISTRADORA DE CONSÓRCIOS LTDA.;Ausência de prestação de informações sobre as regras de funcionamento do consórcio;5;5;0;10;
2022;1º;00000776;ITAÚ ADMINISTRADORA DE CONSÓRCIOS LTDA.;Descumprimento de cláusulas referentes à devolução de valores;1;12;0;13;
2022;1º;00000776;ITAÚ ADMINISTRADORA DE CONSÓRCIOS LTDA.;Descumprimento de obrigações previstas em contratos;2;5;0;7;
2022;1º;00000776;ITAÚ ADMINISTRADORA DE CONSÓRCIOS LTDA.;Falhas operacionais nos processos ou no sistema da Administradora;22;13;0;35;
2022;1º;00000776;ITAÚ ADMINISTRADORA DE CONSÓRCIOS LTDA.;Insatisfação com a resposta fornecida pela administradora de consórcio relativa à demanda registrada contra ela;0;5;0;5;
2022;1º;00000776;ITAÚ ADMINISTRADORA DE CONSÓRCIOS LTDA.;Insatisfação por parte do cliente com o atendimento prestado pela administradora de consórcio;0;0;1;1;
2022;1º;00000776;ITAÚ ADMINISTRADORA DE CONSÓRCIOS LTDA.;Irregularidades relacionadas a informações e liquidação de valores a receber no sistema SVR do BCB por parte de consórcios;0;2;0;2;
2022;1º;00000776;ITAÚ ADMINISTRADORA DE CONSÓRCIOS LTDA.;Irregularidades relacionadas à liberação do crédito;2;17;0;19;
2022;1º;00000776;ITAÚ ADMINISTRADORA DE CONSÓRCIOS LTDA.;Irregularidades relacionadas às condições para contemplação por lance ou sorteio;2;2;0;4;
2022;1º;00000776;ITAÚ ADMINISTRADORA DE CONSÓRCIOS LTDA.;Não fornecimento, remessa ou divulgação de documentos obrigatórios;1;1;0;2;
2022;1º;00000776;ITAÚ ADMINISTRADORA DE CONSÓRCIOS LTDA.;Reclamações relacionadas a assuntos diversos;0;0;5;5;
2022;1º;42421776;ITAÚ UNIBANCO VEÍCULOS ADMINISTRADORA DE CONSÓRCIOS LTDA.;Irregularidades relacionadas à liberação do crédito;0;1;0;1;
2022;1º;60250776;LUIZA ADMINISTRADORA DE CONSÓRCIOS LTDA;Ausência de prestação de informações sobre as regras de funcionamento do consórcio;2;0;0;2;
2022;1º;60250776;LUIZA ADMINISTRADORA DE CONSÓRCIOS LTDA;Descumprimento de obrigações previstas em contratos;0;2;0;2;
2022;1º;60250776;LUIZA ADMINISTRADORA DE CONSÓRCIOS LTDA;Falhas operacionais nos processos ou no sistema da Administradora;1;3;0;4;
2022;1º;60250776;LUIZA ADMINISTRADORA DE CONSÓRCIOS LTDA;Irregularidades relacionadas a informações e liquidação de valores a receber no sistema SVR do BCB por parte de consórcios;1;1;0;2;
2022;1º;60250776;LUIZA ADMINISTRADORA DE CONSÓRCIOS LTDA;Irregularidades relacionadas às condições para contemplação por lance ou sorteio;0;1;0;1;
2022;1º;04250224;MAGGI ADMINISTRADORA DE CONSÓRCIOS LTDA;Irregularidades relacionadas à liberação do crédito;0;1;0;1;
2022;1º;45793395;MASSEY FERGUSON ADMINISTRADORA DE CONSÓRCIOS LTDA;Descumprimento de cláusulas referentes à devolução de valores;0;1;0;1;
2022;1º;45793395;MASSEY FERGUSON ADMINISTRADORA DE CONSÓRCIOS LTDA;Descumprimento de obrigações previstas em contratos;0;1;0;1;
2022;1º;45793395;MASSEY FERGUSON ADMINISTRADORA DE CONSÓRCIOS LTDA;Irregularidades relacionadas a informações e liquidação de valores a receber no sistema SVR do BCB por parte de consórcios;0;1;0;1;
2022;1º;45793395;MASSEY FERGUSON ADMINISTRADORA DE CONSÓRCIOS LTDA;Irregularidades relacionadas à liberação do crédito;0;1;0;1;
2022;1º;45793395;MASSEY FERGUSON ADMINISTRADORA DE CONSÓRCIOS LTDA;Não fornecimento, remessa ou divulgação de documentos obrigatórios;0;1;0;1;
2022;1º;46349106;MERCABENCO ADMINISTRADORA DE CONSORCIO LTDA;Falhas operacionais nos processos ou no sistema da Administradora;1;0;0;1;
2022;1º;04124922;MULTIMARCAS ADMINISTRADORA DE CONSORCIOS LTDA.;Ausência de prestação de informações sobre as regras de funcionamento do consórcio;9;2;0;11;
2022;1º;04124922;MULTIMARCAS ADMINISTRADORA DE CONSORCIOS LTDA.;Descumprimento de cláusulas referentes à devolução de valores;0;5;0;5;
2022;1º;04124922;MULTIMARCAS ADMINISTRADORA DE CONSORCIOS LTDA.;Insatisfação com a resposta fornecida pela administradora de consórcio relativa à demanda registrada contra ela;1;9;0;10;
2022;1º;04124922;MULTIMARCAS ADMINISTRADORA DE CONSORCIOS LTDA.;Irregularidades relacionadas à liberação do crédito;0;1;0;1;
2022;1º;04124922;MULTIMARCAS ADMINISTRADORA DE CONSORCIOS LTDA.;Reclamações relacionadas a assuntos diversos;0;0;1;1;
2022;1º;05395814;NOVOTEMPO ADMINISTRADORA DE CONSORCIOS LTDA.;Irregularidades relacionadas à liberação do crédito;0;1;0;1;
2022;1º;50533876;PAN ADMINISTRADORA DE CONSORCIO LTDA;Irregularidades relacionadas a informações e liquidação de valores a receber no sistema SVR do BCB por parte de consórcios;1;4;0;5;
2022;1º;48041735;PORTO SEGURO ADMINISTRADORA DE CONSÓRCIOS LTDA;Ausência de prestação de informações sobre as regras de funcionamento do consórcio;1;0;0;1;
2022;1º;48041735;PORTO SEGURO ADMINISTRADORA DE CONSÓRCIOS LTDA;Descumprimento de cláusulas referentes à devolução de valores;0;4;0;4;
2022;1º;48041735;PORTO SEGURO ADMINISTRADORA DE CONSÓRCIOS LTDA;Descumprimento de obrigações previstas em contratos;0;5;0;5;
2022;1º;48041735;PORTO SEGURO ADMINISTRADORA DE CONSÓRCIOS LTDA;Falhas operacionais nos processos ou no sistema da Administradora;16;2;0;18;
2022;1º;48041735;PORTO SEGURO ADMINISTRADORA DE CONSÓRCIOS LTDA;Insatisfação com a resposta fornecida pela administradora de consórcio relativa à demanda registrada contra ela;0;5;0;5;
2022;1º;48041735;PORTO SEGURO ADMINISTRADORA DE CONSÓRCIOS LTDA;Insatisfação por parte do cliente com o atendimento prestado pela administradora de consórcio;0;0;4;4;
2022;1º;48041735;PORTO SEGURO ADMINISTRADORA DE CONSÓRCIOS LTDA;Irregularidades relacionadas a informações e liquidação de valores a receber no sistema SVR do BCB por parte de consórcios;2;5;0;7;
2022;1º;48041735;PORTO SEGURO ADMINISTRADORA DE CONSÓRCIOS LTDA;Irregularidades relacionadas à liberação do crédito;1;5;0;6;
2022;1º;48041735;PORTO SEGURO ADMINISTRADORA DE CONSÓRCIOS LTDA;Irregularidades relacionadas às condições para contemplação por lance ou sorteio;0;2;0;2;
2022;1º;48041735;PORTO SEGURO ADMINISTRADORA DE CONSÓRCIOS LTDA;Não fornecimento, remessa ou divulgação de documentos obrigatórios;1;0;0;1;
2022;1º;48041735;PORTO SEGURO ADMINISTRADORA DE CONSÓRCIOS LTDA;Reclamações relacionadas a assuntos diversos;0;0;2;2;
2022;1º;87433413;PORTOBENS ADMINISTRADORA DE CONSORCIOS LTDA;Irregularidades relacionadas a informações e liquidação de valores a receber no sistema SVR do BCB por parte de consórcios;0;1;0;1;
2022;1º;51597300;PRIMO ROSSI ADMINISTRADORA DE CONSÓRCIO LTDA.;Descumprimento de obrigações previstas em contratos;0;1;0;1;
2022;1º;51597300;PRIMO ROSSI ADMINISTRADORA DE CONSÓRCIO LTDA.;Falhas operacionais nos processos ou no sistema da Administradora;0;1;0;1;
2022;1º;51597300;PRIMO ROSSI ADMINISTRADORA DE CONSÓRCIO LTDA.;Irregularidades relacionadas a informações e liquidação de valores a receber no sistema SVR do BCB por parte de consórcios;0;1;0;1;
2022;1º;91108027;RANDON ADMINISTRADORA DE CONSÓRCIOS LTDA.;Descumprimento de cláusulas referentes à devolução de valores;0;3;0;3;
2022;1º;91108027;RANDON ADMINISTRADORA DE CONSÓRCIOS LTDA.;Falhas operacionais nos processos ou no sistema da Administradora;1;0;0;1;
2022;1º;91108027;RANDON ADMINISTRADORA DE CONSÓRCIOS LTDA.;Irregularidades relacionadas à liberação do crédito;0;1;0;1;
2022;1º;91108027;RANDON ADMINISTRADORA DE CONSÓRCIOS LTDA.;Reclamações relacionadas a assuntos diversos;0;0;1;1;
2022;1º;23767155;RECON ADMINISTRADORA DE CONSORCIOS LTDA;Ausência de prestação de informações sobre as regras de funcionamento do consórcio;0;1;0;1;
2022;1º;23767155;RECON ADMINISTRADORA DE CONSORCIOS LTDA;Descumprimento de cláusulas referentes à devolução de valores;0;2;0;2;
2022;1º;23767155;RECON ADMINISTRADORA DE CONSORCIOS LTDA;Falhas operacionais nos processos ou no sistema da Administradora;2;0;0;2;
2022;1º;23767155;RECON ADMINISTRADORA DE CONSORCIOS LTDA;Irregularidades relacionadas a informações e liquidação de valores a receber no sistema SVR do BCB por parte de consórcios;0;1;0;1;
2022;1º;62354055;REMAZA ADMINISTRADORA DE CONSÓRCIO LTDA.;Ausência de prestação de informações sobre as regras de funcionamento do consórcio;2;1;0;3;
2022;1º;62354055;REMAZA ADMINISTRADORA DE CONSÓRCIO LTDA.;Descumprimento de cláusulas referentes à devolução de valores;0;6;0;6;
2022;1º;62354055;REMAZA ADMINISTRADORA DE CONSÓRCIO LTDA.;Descumprimento de obrigações previstas em contratos;0;1;0;1;
2022;1º;62354055;REMAZA ADMINISTRADORA DE CONSÓRCIO LTDA.;Descumprimento de prazo de resposta a demanda;0;1;0;1;
2022;1º;62354055;REMAZA ADMINISTRADORA DE CONSÓRCIO LTDA.;Falhas operacionais nos processos ou no sistema da Administradora;3;0;0;3;
2022;1º;62354055;REMAZA ADMINISTRADORA DE CONSÓRCIO LTDA.;Insatisfação com a resposta fornecida pela administradora de consórcio relativa à demanda registrada contra ela;0;2;0;2;
2022;1º;62354055;REMAZA ADMINISTRADORA DE CONSÓRCIO LTDA.;Insatisfação por parte do cliente com o atendimento prestado pela administradora de consórcio;0;0;2;2;
2022;1º;62354055;REMAZA ADMINISTRADORA DE CONSÓRCIO LTDA.;Irregularidades relacionadas a informações e liquidação de valores a receber no sistema SVR do BCB por parte de consórcios;0;2;0;2;
2022;1º;62354055;REMAZA ADMINISTRADORA DE CONSÓRCIO LTDA.;Irregularidades relacionadas à liberação do crédito;1;0;0;1;
2022;1º;28904092;RESERVA ADMINISTRADORA DE CONSÓRCIO LTDA;Ausência de prestação de informações sobre as regras de funcionamento do consórcio;7;5;0;12;
2022;1º;28904092;RESERVA ADMINISTRADORA DE CONSÓRCIO LTDA;Ausência de transparência nas relações contratuais;0;0;1;1;
2022;1º;28904092;RESERVA ADMINISTRADORA DE CONSÓRCIO LTDA;Descumprimento de cláusulas referentes à devolução de valores;0;1;0;1;
2022;1º;28904092;RESERVA ADMINISTRADORA DE CONSÓRCIO LTDA;Descumprimento de prazo de resposta a demanda;0;1;0;1;
2022;1º;28904092;RESERVA ADMINISTRADORA DE CONSÓRCIO LTDA;Insatisfação com a resposta fornecida pela administradora de consórcio relativa à demanda registrada contra ela;0;3;0;3;
2022;1º;51855716;RODOBENS ADMINISTRADORA DE CONSÓRCIOS LTDA.;Ausência de prestação de informações sobre as regras de funcionamento do consórcio;3;2;0;5;
2022;1º;51855716;RODOBENS ADMINISTRADORA DE CONSÓRCIOS LTDA.;Ausência de transparência nas relações contratuais;0;0;2;2;
2022;1º;51855716;RODOBENS ADMINISTRADORA DE CONSÓRCIOS LTDA.;Descumprimento de cláusulas referentes à devolução de valores;0;10;0;10;
2022;1º;51855716;RODOBENS ADMINISTRADORA DE CONSÓRCIOS LTDA.;Descumprimento de obrigações previstas em contratos;1;3;0;4;
2022;1º;51855716;RODOBENS ADMINISTRADORA DE CONSÓRCIOS LTDA.;Falhas operacionais nos processos ou no sistema da Administradora;6;8;0;14;
2022;1º;51855716;RODOBENS ADMINISTRADORA DE CONSÓRCIOS LTDA.;Insatisfação por parte do cliente com o atendimento prestado pela administradora de consórcio;0;0;2;2;
2022;1º;51855716;RODOBENS ADMINISTRADORA DE CONSÓRCIOS LTDA.;Irregularidades relacionadas a informações e liquidação de valores a receber no sistema SVR do BCB por parte de consórcios;0;6;0;6;
2022;1º;51855716;RODOBENS ADMINISTRADORA DE CONSÓRCIOS LTDA.;Irregularidades relacionadas à liberação do crédito;0;2;0;2;
2022;1º;51855716;RODOBENS ADMINISTRADORA DE CONSÓRCIOS LTDA.;Irregularidades relacionadas às condições para contemplação por lance ou sorteio;0;1;0;1;
2022;1º;51855716;RODOBENS ADMINISTRADORA DE CONSÓRCIOS LTDA.;Não fornecimento, remessa ou divulgação de documentos obrigatórios;1;0;0;1;
2022;1º;51855716;RODOBENS ADMINISTRADORA DE CONSÓRCIOS LTDA.;Reclamações relacionadas a assuntos diversos;0;0;3;3;
2022;1º;55942312;SANTANDER BRASIL ADMINISTRADORA DE CONSÓRCIO LTDA.;Ausência de prestação de informações sobre as regras de funcionamento do consórcio;3;5;0;8;
2022;1º;55942312;SANTANDER BRASIL ADMINISTRADORA DE CONSÓRCIO LTDA.;Ausência de transparência nas relações contratuais;0;0;2;2;
2022;1º;55942312;SANTANDER BRASIL ADMINISTRADORA DE CONSÓRCIO LTDA.;Descumprimento de cláusulas referentes à devolução de valores;1;10;0;11;
2022;1º;55942312;SANTANDER BRASIL ADMINISTRADORA DE CONSÓRCIO LTDA.;Descumprimento de obrigações previstas em contratos;0;6;0;6;
2022;1º;55942312;SANTANDER BRASIL ADMINISTRADORA DE CONSÓRCIO LTDA.;Falhas operacionais nos processos ou no sistema da Administradora;35;27;0;62;
2022;1º;55942312;SANTANDER BRASIL ADMINISTRADORA DE CONSÓRCIO LTDA.;Insatisfação com a resposta fornecida pela administradora de consórcio relativa à demanda registrada contra ela;1;7;0;8;
2022;1º;55942312;SANTANDER BRASIL ADMINISTRADORA DE CONSÓRCIO LTDA.;Insatisfação por parte do cliente com o atendimento prestado pela administradora de consórcio;0;0;2;2;
2022;1º;55942312;SANTANDER BRASIL ADMINISTRADORA DE CONSÓRCIO LTDA.;Irregularidades relacionadas a informações e liquidação de valores a receber no sistema SVR do BCB por parte de consórcios;9;6;0;15;
2022;1º;55942312;SANTANDER BRASIL ADMINISTRADORA DE CONSÓRCIO LTDA.;Irregularidades relacionadas à liberação do crédito;2;38;0;40;
2022;1º;55942312;SANTANDER BRASIL ADMINISTRADORA DE CONSÓRCIO LTDA.;Irregularidades relacionadas às condições para contemplação por lance ou sorteio;1;4;0;5;
2022;1º;55942312;SANTANDER BRASIL ADMINISTRADORA DE CONSÓRCIO LTDA.;Não fornecimento, remessa ou divulgação de documentos obrigatórios;2;3;0;5;
2022;1º;55942312;SANTANDER BRASIL ADMINISTRADORA DE CONSÓRCIO LTDA.;Reclamações relacionadas a assuntos diversos;0;0;7;7;
2022;1º;96479258;SCANIA ADMINISTRADORA DE CONSÓRCIOS LTDA.;Ausência de transparência nas relações contratuais;0;0;1;1;
2022;1º;96479258;SCANIA ADMINISTRADORA DE CONSÓRCIOS LTDA.;Irregularidades relacionadas à liberação do crédito;0;1;0;1;
2022;1º;76515071;SERVOPA ADMINISTRADORA DE CONSORCIOS LTDA;Descumprimento de obrigações previstas em contratos;0;1;0;1;
2022;1º;76515071;SERVOPA ADMINISTRADORA DE CONSORCIOS LTDA;Falhas operacionais nos processos ou no sistema da Administradora;1;0;0;1;
2022;1º;16551061;SICOOB ADMINISTRADORA DE CONSÓRCIOS LTDA.;Ausência de prestação de informações sobre as regras de funcionamento do consórcio;3;1;0;4;
2022;1º;16551061;SICOOB ADMINISTRADORA DE CONSÓRCIOS LTDA.;Ausência de transparência nas relações contratuais;0;0;1;1;
2022;1º;16551061;SICOOB ADMINISTRADORA DE CONSÓRCIOS LTDA.;Descumprimento de cláusulas referentes à devolução de valores;1;3;0;4;
2022;1º;16551061;SICOOB ADMINISTRADORA DE CONSÓRCIOS LTDA.;Descumprimento de obrigações previstas em contratos;0;4;0;4;
2022;1º;16551061;SICOOB ADMINISTRADORA DE CONSÓRCIOS LTDA.;Falhas operacionais nos processos ou no sistema da Administradora;5;5;0;10;
2022;1º;16551061;SICOOB ADMINISTRADORA DE CONSÓRCIOS LTDA.;Insatisfação com a resposta fornecida pela administradora de consórcio relativa à demanda registrada contra ela;0;2;0;2;
2022;1º;16551061;SICOOB ADMINISTRADORA DE CONSÓRCIOS LTDA.;Irregularidades relacionadas a informações e liquidação de valores a receber no sistema SVR do BCB por parte de consórcios;0;2;0;2;
2022;1º;16551061;SICOOB ADMINISTRADORA DE CONSÓRCIOS LTDA.;Irregularidades relacionadas à liberação do crédito;0;9;0;9;
2022;1º;16551061;SICOOB ADMINISTRADORA DE CONSÓRCIOS LTDA.;Irregularidades relacionadas às condições para contemplação por lance ou sorteio;0;1;0;1;
2022;1º;16551061;SICOOB ADMINISTRADORA DE CONSÓRCIOS LTDA.;Não fornecimento, remessa ou divulgação de documentos obrigatórios;1;1;0;2;
2022;1º;87945218;SIMPALA LANÇADORA E ADMINISTRADORA DE CONSÓRCIOS LTDA.;Irregularidades relacionadas a informações e liquidação de valores a receber no sistema SVR do BCB por parte de consórcios;0;1;0;1;
2022;1º;87852273;SINOSSERRA ADMINISTRADORA DE CONSÓRCIOS LTDA;Falhas operacionais nos processos ou no sistema da Administradora;1;0;0;1;
2022;1º;87852273;SINOSSERRA ADMINISTRADORA DE CONSÓRCIOS LTDA;Irregularidades relacionadas a informações e liquidação de valores a receber no sistema SVR do BCB por parte de consórcios;1;0;0;1;
2022;1º;87636635;SPONCHIADO ADMINISTRADORA DE CONSÓRCIOS LTDA.;Ausência de prestação de informações sobre as regras de funcionamento do consórcio;1;0;0;1;
2022;1º;57723801;SUZUKI MOTOS ADMINISTRADORA DE CONSÓRCIO LTDA.;Falhas operacionais nos processos ou no sistema da Administradora;1;0;0;1;
2022;1º;05551841;TÁGIDE ADMINISTRADORA DE CONSÓRCIOS LTDA.;Ausência de prestação de informações sobre as regras de funcionamento do consórcio;5;0;0;5;
2022;1º;05551841;TÁGIDE ADMINISTRADORA DE CONSÓRCIOS LTDA.;Descumprimento de obrigações previstas em contratos;0;1;0;1;
2022;1º;05551841;TÁGIDE ADMINISTRADORA DE CONSÓRCIOS LTDA.;Irregularidades relacionadas a informações e liquidação de valores a receber no sistema SVR do BCB por parte de consórcios;0;2;0;2;
2022;1º;59956185;TRADIÇÃO ADMINISTRADORA DE CONSÓRCIO LTDA.;Ausência de prestação de informações sobre as regras de funcionamento do consórcio;7;2;0;9;
2022;1º;59956185;TRADIÇÃO ADMINISTRADORA DE CONSÓRCIO LTDA.;Descumprimento de cláusulas referentes à devolução de valores;0;2;0;2;
2022;1º;59956185;TRADIÇÃO ADMINISTRADORA DE CONSÓRCIO LTDA.;Descumprimento de obrigações previstas em contratos;1;1;0;2;
2022;1º;59956185;TRADIÇÃO ADMINISTRADORA DE CONSÓRCIO LTDA.;Falhas operacionais nos processos ou no sistema da Administradora;1;1;0;2;
2022;1º;59956185;TRADIÇÃO ADMINISTRADORA DE CONSÓRCIO LTDA.;Irregularidades relacionadas a informações e liquidação de valores a receber no sistema SVR do BCB por parte de consórcios;0;1;0;1;
2022;1º;78199262;TRIÂNGULO ADMINISTRADORA DE CONSÓRCIOS LTDA;Descumprimento de prazo de resposta a demanda;1;0;0;1;
2022;1º;78199262;TRIÂNGULO ADMINISTRADORA DE CONSÓRCIOS LTDA;Falhas operacionais nos processos ou no sistema da Administradora;2;0;0;2;
2022;1º;83553883;UNIÃO CATARINENSE ADMINISTRADORA DE CONSORCIOS LTDA;Irregularidades relacionadas às condições para contemplação por lance ou sorteio;0;1;0;1;
2022;1º;60732997;UNIFISA ADMINISTRADORA NACIONAL DE CONSORCIOS LTDA;Ausência de prestação de informações sobre as regras de funcionamento do consórcio;4;4;0;8;
2022;1º;60732997;UNIFISA ADMINISTRADORA NACIONAL DE CONSORCIOS LTDA;Descumprimento de cláusulas referentes à devolução de valores;0;2;0;2;
2022;1º;60732997;UNIFISA ADMINISTRADORA NACIONAL DE CONSORCIOS LTDA;Descumprimento de obrigações previstas em contratos;1;1;0;2;
2022;1º;60732997;UNIFISA ADMINISTRADORA NACIONAL DE CONSORCIOS LTDA;Falhas operacionais nos processos ou no sistema da Administradora;1;1;0;2;
2022;1º;60732997;UNIFISA ADMINISTRADORA NACIONAL DE CONSORCIOS LTDA;Insatisfação por parte do cliente com o atendimento prestado pela administradora de consórcio;0;0;1;1;
2022;1º;60732997;UNIFISA ADMINISTRADORA NACIONAL DE CONSORCIOS LTDA;Irregularidades relacionadas a informações e liquidação de valores a receber no sistema SVR do BCB por parte de consórcios;0;1;0;1;
2022;1º;60732997;UNIFISA ADMINISTRADORA NACIONAL DE CONSORCIOS LTDA;Irregularidades relacionadas à liberação do crédito;0;3;0;3;
2022;1º;56360266;VALTRA ADMINISTRADORA DE CONSÓRCIOS LTDA;Irregularidades relacionadas a informações e liquidação de valores a receber no sistema SVR do BCB por parte de consórcios;0;1;0;1;
2022;1º;56360266;VALTRA ADMINISTRADORA DE CONSÓRCIOS LTDA;Não fornecimento, remessa ou divulgação de documentos obrigatórios;0;1;0;1;
2022;1º;45594223;VEMAR ADMINISTRADORA DE CONSÓRCIO LTDA.;Irregularidades relacionadas a informações e liquidação de valores a receber no sistema SVR do BCB por parte de consórcios;1;0;0;1;
2022;1º;49995293;VINAC ADMINISTRADORA DE CONSÓRCIOS LTDA.;Ausência de prestação de informações sobre as regras de funcionamento do consórcio;1;0;0;1;
2022;1º;50827237;VKN ADMINISTRADORA DE CONSÓRCIO LTDA.;Ausência de prestação de informações sobre as regras de funcionamento do consórcio;0;1;0;1;
2022;1º;74118381;VOLVO ADMINISTRADORA DE CONSÓRCIO LTDA.;Descumprimento de cláusulas referentes à devolução de valores;1;0;0;1;
2022;1º;47458153;YAMAHA ADMINISTRADORA DE CONSÓRCIO LTDA.;Descumprimento de cláusulas referentes à devolução de valores;0;3;0;3;
2022;1º;47458153;YAMAHA ADMINISTRADORA DE CONSÓRCIO LTDA.;Descumprimento de obrigações previstas em contratos;0;2;0;2;
2022;1º;47458153;YAMAHA ADMINISTRADORA DE CONSÓRCIO LTDA.;Falhas operacionais nos processos ou no sistema da Administradora;2;0;0;2;
2022;1º;47458153;YAMAHA ADMINISTRADORA DE CONSÓRCIO LTDA.;Insatisfação com a resposta fornecida pela administradora de consórcio relativa à demanda registrada contra ela;0;1;0;1;
2022;1º;47458153;YAMAHA ADMINISTRADORA DE CONSÓRCIO LTDA.;Irregularidades relacionadas a informações e liquidação de valores a receber no sistema SVR do BCB por parte de consórcios;1;3;0;4;
2022;1º;47458153;YAMAHA ADMINISTRADORA DE CONSÓRCIO LTDA.;Irregularidades relacionadas à liberação do crédito;1;2;0;3;
2022;1º;47458153;YAMAHA ADMINISTRADORA DE CONSÓRCIO LTDA.;Irregularidades relacionadas às condições para contemplação por lance ou sorteio;0;1;0;1;
2022;1º;47458153;YAMAHA ADMINISTRADORA DE CONSÓRCIO LTDA.;Não fornecimento, remessa ou divulgação de documentos obrigatórios;0;2;0;2;
2022;1º;23367634;ZEMA ADMINISTRADORA DE CONSÓRCIO LTDA;Ausência de prestação de informações sobre as regras de funcionamento do consórcio;2;0;0;2;
2022;1º;23367634;ZEMA ADMINISTRADORA DE CONSÓRCIO LTDA;Descumprimento de cláusulas referentes à devolução de valores;0;4;0;4;
2022;1º;23367634;ZEMA ADMINISTRADORA DE CONSÓRCIO LTDA;Falhas operacionais nos processos ou no sistema da Administradora;0;1;0;1;
2022;1º;23367634;ZEMA ADMINISTRADORA DE CONSÓRCIO LTDA;Irregularidades relacionadas a informações e liquidação de valores a receber no sistema SVR do BCB por parte de consórcios;0;1;0;1;
