Ano;Semestre;CNPJ AC;Administradora de consórcio;Irregularidade;Quantidade de reclamações reguladas procedentes;Quantidade de reclamações reguladas - outras;Quantidade de reclamações não reguladas;Quantidade total de reclamações;
2018;1º;91984633;ACERTE ADMINISTRADORA DE CONSÓRCIOS LTDA.;Descumprimento de cláusulas referentes à devolução de valores;0;1;0;1;
2018;1º;91984633;ACERTE ADMINISTRADORA DE CONSÓRCIOS LTDA.;Descumprimento de prazo de resposta a demanda;1;2;0;3;
2018;1º;91984633;ACERTE ADMINISTRADORA DE CONSÓRCIOS LTDA.;Insatisfação com a resposta fornecida pela administradora de consórcio relativa à demanda registrada contra ela;0;3;0;3;
2018;1º;91984633;ACERTE ADMINISTRADORA DE CONSÓRCIOS LTDA.;Outras irregularidades;1;12;0;13;
2018;1º;91984633;ACERTE ADMINISTRADORA DE CONSÓRCIOS LTDA.;Prestação inadequada/insuficiente de informação;0;0;4;4;
2018;1º;91984633;ACERTE ADMINISTRADORA DE CONSÓRCIOS LTDA.;Publicidade enganosa;0;0;6;6;
2018;1º;91984633;ACERTE ADMINISTRADORA DE CONSÓRCIOS LTDA.;Reclamações relacionadas a assuntos diversos;0;0;2;2;
2018;1º;84911098;ADEMILAR ADMINISTRADORA DE CONSORCIOS S.A.;Irregularidades relacionadas às condições para contemplação por lance ou sorteio;0;1;0;1;
2018;1º;84911098;ADEMILAR ADMINISTRADORA DE CONSORCIOS S.A.;Prestação inadequada/insuficiente de informação;0;0;2;2;
2018;1º;06044551;ADMINISTRADORA DE CONSORCIO NACIONAL GAZIN LTDA;Dificuldade na liberação ou substituição de bem;0;0;1;1;
2018;1º;06044551;ADMINISTRADORA DE CONSORCIO NACIONAL GAZIN LTDA;Insatisfação por parte do cliente com o atendimento prestado pela administradora de consórcio;0;0;1;1;
2018;1º;06044551;ADMINISTRADORA DE CONSORCIO NACIONAL GAZIN LTDA;Irregularidades relacionadas à liberação do crédito;1;0;0;1;
2018;1º;45441789;ADMINISTRADORA DE CONSORCIO NACIONAL HONDA LTDA;Ausência de transparência nas relações contratuais;0;0;9;9;
2018;1º;45441789;ADMINISTRADORA DE CONSORCIO NACIONAL HONDA LTDA;Descumprimento de cláusulas referentes à devolução de valores;1;31;0;32;
2018;1º;45441789;ADMINISTRADORA DE CONSORCIO NACIONAL HONDA LTDA;Descumprimento de obrigações previstas em contratos;3;2;0;5;
2018;1º;45441789;ADMINISTRADORA DE CONSORCIO NACIONAL HONDA LTDA;Descumprimento de prazo de resposta a demanda;0;3;0;3;
2018;1º;45441789;ADMINISTRADORA DE CONSORCIO NACIONAL HONDA LTDA;Dificuldade na liberação ou substituição de bem;0;0;8;8;
2018;1º;45441789;ADMINISTRADORA DE CONSORCIO NACIONAL HONDA LTDA;Insatisfação com a resposta fornecida pela administradora de consórcio relativa à demanda registrada contra ela;1;9;0;10;
2018;1º;45441789;ADMINISTRADORA DE CONSORCIO NACIONAL HONDA LTDA;Insatisfação por parte do cliente com o atendimento prestado pela administradora de consórcio;0;0;9;9;
2018;1º;45441789;ADMINISTRADORA DE CONSORCIO NACIONAL HONDA LTDA;Irregularidades relacionadas à liberação do crédito;1;26;0;27;
2018;1º;45441789;ADMINISTRADORA DE CONSORCIO NACIONAL HONDA LTDA;Irregularidades relacionadas às condições para contemplação por lance ou sorteio;0;6;0;6;
2018;1º;45441789;ADMINISTRADORA DE CONSORCIO NACIONAL HONDA LTDA;Não fornecimento, remessa ou divulgação de documentos obrigatórios;0;1;0;1;
2018;1º;45441789;ADMINISTRADORA DE CONSORCIO NACIONAL HONDA LTDA;Outras irregularidades;0;2;0;2;
2018;1º;45441789;ADMINISTRADORA DE CONSORCIO NACIONAL HONDA LTDA;Prestação inadequada/insuficiente de informação;0;0;5;5;
2018;1º;45441789;ADMINISTRADORA DE CONSORCIO NACIONAL HONDA LTDA;Reclamações relacionadas a assuntos diversos;0;0;24;24;
2018;1º;45441789;ADMINISTRADORA DE CONSORCIO NACIONAL HONDA LTDA;Recusa ou demora no fornecimento de documentos (exceto demonstrativos obrigatórios);0;0;9;9;
2018;1º;07808907;ADMINISTRADORA DE CONSORCIOS SICREDI LTDA;Descumprimento de cláusulas referentes à devolução de valores;0;1;0;1;
2018;1º;07808907;ADMINISTRADORA DE CONSORCIOS SICREDI LTDA;Descumprimento de prazo de resposta a demanda;0;1;0;1;
2018;1º;07808907;ADMINISTRADORA DE CONSORCIOS SICREDI LTDA;Irregularidades relacionadas à liberação do crédito;0;2;0;2;
2018;1º;73230674;ADMINISTRADORA DE CONSÓRCIO RCI BRASIL LTDA;Ausência de transparência nas relações contratuais;0;0;2;2;
2018;1º;73230674;ADMINISTRADORA DE CONSÓRCIO RCI BRASIL LTDA;Descumprimento de cláusulas referentes à devolução de valores;0;2;0;2;
2018;1º;73230674;ADMINISTRADORA DE CONSÓRCIO RCI BRASIL LTDA;Descumprimento de obrigações previstas em contratos;0;2;0;2;
2018;1º;73230674;ADMINISTRADORA DE CONSÓRCIO RCI BRASIL LTDA;Irregularidades relacionadas à liberação do crédito;0;1;0;1;
2018;1º;73230674;ADMINISTRADORA DE CONSÓRCIO RCI BRASIL LTDA;Prestação inadequada/insuficiente de informação;0;0;2;2;
2018;1º;03765340;ADMINISTRADORA DE CONSÓRCIO REGIONAL WAY LTDA.;Ausência de transparência nas relações contratuais;0;0;1;1;
2018;1º;03765340;ADMINISTRADORA DE CONSÓRCIO REGIONAL WAY LTDA.;Golpe;0;0;1;1;
2018;1º;03765340;ADMINISTRADORA DE CONSÓRCIO REGIONAL WAY LTDA.;Insatisfação com a resposta fornecida pela administradora de consórcio relativa à demanda registrada contra ela;0;3;0;3;
2018;1º;03765340;ADMINISTRADORA DE CONSÓRCIO REGIONAL WAY LTDA.;Irregularidades relacionadas às condições para contemplação por lance ou sorteio;0;2;0;2;
2018;1º;03765340;ADMINISTRADORA DE CONSÓRCIO REGIONAL WAY LTDA.;Outras irregularidades;2;5;0;7;
2018;1º;03765340;ADMINISTRADORA DE CONSÓRCIO REGIONAL WAY LTDA.;Prestação inadequada/insuficiente de informação;0;0;1;1;
2018;1º;03765340;ADMINISTRADORA DE CONSÓRCIO REGIONAL WAY LTDA.;Publicidade enganosa;0;0;9;9;
2018;1º;91341925;ADMINISTRADORA DE CONSÓRCIO SPENGLER LTDA.;Irregularidades relacionadas à liberação do crédito;0;1;0;1;
2018;1º;91341925;ADMINISTRADORA DE CONSÓRCIO SPENGLER LTDA.;Outras irregularidades relacionadas à Ouvidoria;0;1;0;1;
2018;1º;91341925;ADMINISTRADORA DE CONSÓRCIO SPENGLER LTDA.;Prestação inadequada/insuficiente de informação;0;0;1;1;
2018;1º;12228808;ADMINISTRADORA DE CONSÓRCIO UNICOOB LTDA;Cobrança irregular de tarifa pela emissão de boletos, carnês e assemelhados;0;1;0;1;
2018;1º;03828278;ADMINISTRADORA DE CONSÓRCIOS BECKER LTDA.;Descumprimento de obrigações previstas em contratos;0;1;0;1;
2018;1º;94187879;AGIPLAN ADMINISTRADORA DE CONSÓRCIOS LTDA;Irregularidades relacionadas à liberação do crédito;0;1;0;1;
2018;1º;94187879;AGIPLAN ADMINISTRADORA DE CONSÓRCIOS LTDA;Outras irregularidades;0;1;0;1;
2018;1º;94187879;AGIPLAN ADMINISTRADORA DE CONSÓRCIOS LTDA;Prestação inadequada/insuficiente de informação;0;0;2;2;
2018;1º;94187879;AGIPLAN ADMINISTRADORA DE CONSÓRCIOS LTDA;Publicidade enganosa;0;0;1;1;
2018;1º;94187879;AGIPLAN ADMINISTRADORA DE CONSÓRCIOS LTDA;Reclamações relacionadas a assuntos diversos;0;0;1;1;
2018;1º;60375243;ANCORA ADMINISTRADORA DE CONSORCIOS S.A.;Descumprimento de cláusulas referentes à devolução de valores;0;1;0;1;
2018;1º;60375243;ANCORA ADMINISTRADORA DE CONSORCIOS S.A.;Descumprimento de obrigações previstas em contratos;0;1;0;1;
2018;1º;60375243;ANCORA ADMINISTRADORA DE CONSORCIOS S.A.;Insatisfação por parte do cliente com o atendimento prestado pela administradora de consórcio;0;0;1;1;
2018;1º;60375243;ANCORA ADMINISTRADORA DE CONSORCIOS S.A.;Prestação inadequada/insuficiente de informação;0;0;6;6;
2018;1º;60375243;ANCORA ADMINISTRADORA DE CONSORCIOS S.A.;Recusa ou demora no fornecimento de documentos (exceto demonstrativos obrigatórios);0;0;1;1;
2018;1º;07270184;ASSOCIACAO ATLETICA DO BANCO DO BRASIL - CE;Insatisfação por parte do cliente com o atendimento prestado pela administradora de consórcio;0;0;1;1;
2018;1º;07270184;ASSOCIACAO ATLETICA DO BANCO DO BRASIL - CE;Prestação inadequada/insuficiente de informação;0;0;1;1;
2018;1º;71045363;BAMAQ ADMINISTRADORA DE CONSÓRCIOS LTDA;Irregularidades relacionadas à liberação do crédito;0;1;0;1;
2018;1º;02010478;BANCORBRÁS ADMINISTRADORA DE CONSÓRCIOS S.A.;Descumprimento de cláusulas referentes à devolução de valores;0;1;0;1;
2018;1º;02010478;BANCORBRÁS ADMINISTRADORA DE CONSÓRCIOS S.A.;Irregularidades relacionadas às condições para contemplação por lance ou sorteio;0;1;0;1;
2018;1º;02010478;BANCORBRÁS ADMINISTRADORA DE CONSÓRCIOS S.A.;Não fornecimento, remessa ou divulgação de documentos obrigatórios;0;1;0;1;
2018;1º;02010478;BANCORBRÁS ADMINISTRADORA DE CONSÓRCIOS S.A.;Prestação inadequada/insuficiente de informação;0;0;1;1;
2018;1º;02010478;BANCORBRÁS ADMINISTRADORA DE CONSÓRCIOS S.A.;Publicidade enganosa;0;0;1;1;
2018;1º;92692979;BANRISUL S.A. - ADMINISTRADORA DE CONSÓRCIOS;Descumprimento de cláusulas referentes à devolução de valores;0;1;0;1;
2018;1º;92692979;BANRISUL S.A. - ADMINISTRADORA DE CONSÓRCIOS;Descumprimento de obrigações previstas em contratos;1;1;0;2;
2018;1º;92692979;BANRISUL S.A. - ADMINISTRADORA DE CONSÓRCIOS;Irregularidades relacionadas à liberação do crédito;0;2;0;2;
2018;1º;92692979;BANRISUL S.A. - ADMINISTRADORA DE CONSÓRCIOS;Prestação inadequada/insuficiente de informação;0;0;1;1;
2018;1º;06043050;BB ADMINISTRADORA DE CONSORCIOS S.A.;;0;0;1;1;
2018;1º;06043050;BB ADMINISTRADORA DE CONSORCIOS S.A.;Ausência de transparência nas relações contratuais;0;0;7;7;
2018;1º;06043050;BB ADMINISTRADORA DE CONSORCIOS S.A.;Cobrança irregular de tarifa pela emissão de boletos, carnês e assemelhados;0;2;0;2;
2018;1º;06043050;BB ADMINISTRADORA DE CONSORCIOS S.A.;Descumprimento de cláusulas referentes à devolução de valores;0;17;0;17;
2018;1º;06043050;BB ADMINISTRADORA DE CONSORCIOS S.A.;Descumprimento de obrigações previstas em contratos;2;8;0;10;
2018;1º;06043050;BB ADMINISTRADORA DE CONSORCIOS S.A.;Descumprimento de prazo de resposta a demanda;0;3;0;3;
2018;1º;06043050;BB ADMINISTRADORA DE CONSORCIOS S.A.;Dificuldade na liberação ou substituição de bem;0;0;8;8;
2018;1º;06043050;BB ADMINISTRADORA DE CONSORCIOS S.A.;Insatisfação com a resposta fornecida pela administradora de consórcio relativa à demanda registrada contra ela;0;5;0;5;
2018;1º;06043050;BB ADMINISTRADORA DE CONSORCIOS S.A.;Insatisfação por parte do cliente com o atendimento prestado pela administradora de consórcio;0;0;12;12;
2018;1º;06043050;BB ADMINISTRADORA DE CONSORCIOS S.A.;Irregularidades relacionadas à liberação do crédito;1;32;0;33;
2018;1º;06043050;BB ADMINISTRADORA DE CONSORCIOS S.A.;Irregularidades relacionadas às condições para contemplação por lance ou sorteio;0;1;0;1;
2018;1º;06043050;BB ADMINISTRADORA DE CONSORCIOS S.A.;Não fornecimento, remessa ou divulgação de documentos obrigatórios;0;1;0;1;
2018;1º;06043050;BB ADMINISTRADORA DE CONSORCIOS S.A.;Outras irregularidades;0;2;0;2;
2018;1º;06043050;BB ADMINISTRADORA DE CONSORCIOS S.A.;Outras irregularidades relacionadas à Ouvidoria;0;1;0;1;
2018;1º;06043050;BB ADMINISTRADORA DE CONSORCIOS S.A.;Prestação inadequada/insuficiente de informação;0;0;10;10;
2018;1º;06043050;BB ADMINISTRADORA DE CONSORCIOS S.A.;Publicidade enganosa;0;0;1;1;
2018;1º;06043050;BB ADMINISTRADORA DE CONSORCIOS S.A.;Reclamações relacionadas a assuntos diversos;0;0;14;14;
2018;1º;06043050;BB ADMINISTRADORA DE CONSORCIOS S.A.;Recusa ou demora no fornecimento de documentos (exceto demonstrativos obrigatórios);0;0;24;24;
2018;1º;14723388;BR CONSÓRCIOS ADMINISTRADORA DE CONSÓRCIOS LTDA;Ausência de transparência nas relações contratuais;0;0;2;2;
2018;1º;14723388;BR CONSÓRCIOS ADMINISTRADORA DE CONSÓRCIOS LTDA;Descumprimento de cláusulas referentes à devolução de valores;0;5;0;5;
2018;1º;14723388;BR CONSÓRCIOS ADMINISTRADORA DE CONSÓRCIOS LTDA;Descumprimento de obrigações previstas em contratos;0;1;0;1;
2018;1º;14723388;BR CONSÓRCIOS ADMINISTRADORA DE CONSÓRCIOS LTDA;Descumprimento de prazo de resposta a demanda;0;2;0;2;
2018;1º;14723388;BR CONSÓRCIOS ADMINISTRADORA DE CONSÓRCIOS LTDA;Dificuldade na liberação ou substituição de bem;0;0;1;1;
2018;1º;14723388;BR CONSÓRCIOS ADMINISTRADORA DE CONSÓRCIOS LTDA;Insatisfação com a resposta fornecida pela administradora de consórcio relativa à demanda registrada contra ela;0;3;0;3;
2018;1º;14723388;BR CONSÓRCIOS ADMINISTRADORA DE CONSÓRCIOS LTDA;Insatisfação por parte do cliente com o atendimento prestado pela administradora de consórcio;0;0;3;3;
2018;1º;14723388;BR CONSÓRCIOS ADMINISTRADORA DE CONSÓRCIOS LTDA;Outras irregularidades;0;1;0;1;
2018;1º;14723388;BR CONSÓRCIOS ADMINISTRADORA DE CONSÓRCIOS LTDA;Prestação inadequada/insuficiente de informação;0;0;4;4;
2018;1º;14723388;BR CONSÓRCIOS ADMINISTRADORA DE CONSÓRCIOS LTDA;Reclamações relacionadas a assuntos diversos;0;0;1;1;
2018;1º;14723388;BR CONSÓRCIOS ADMINISTRADORA DE CONSÓRCIOS LTDA;Recusa ou demora no fornecimento de documentos (exceto demonstrativos obrigatórios);0;0;3;3;
2018;1º;52568821;BRADESCO ADMINISTRADORA DE CONSÓRCIOS LTDA.;Ausência de transparência nas relações contratuais;0;0;1;1;
2018;1º;52568821;BRADESCO ADMINISTRADORA DE CONSÓRCIOS LTDA.;Cobrança irregular de tarifa pela emissão de boletos, carnês e assemelhados;0;4;0;4;
2018;1º;52568821;BRADESCO ADMINISTRADORA DE CONSÓRCIOS LTDA.;Descumprimento de cláusulas referentes à devolução de valores;0;59;0;59;
2018;1º;52568821;BRADESCO ADMINISTRADORA DE CONSÓRCIOS LTDA.;Descumprimento de obrigações previstas em contratos;4;74;0;78;
2018;1º;52568821;BRADESCO ADMINISTRADORA DE CONSÓRCIOS LTDA.;Descumprimento de prazo de resposta a demanda;0;22;0;22;
2018;1º;52568821;BRADESCO ADMINISTRADORA DE CONSÓRCIOS LTDA.;Dificuldade na liberação ou substituição de bem;0;0;69;69;
2018;1º;52568821;BRADESCO ADMINISTRADORA DE CONSÓRCIOS LTDA.;Insatisfação com a resposta fornecida pela administradora de consórcio relativa à demanda registrada contra ela;1;29;0;30;
2018;1º;52568821;BRADESCO ADMINISTRADORA DE CONSÓRCIOS LTDA.;Insatisfação por parte do cliente com o atendimento prestado pela administradora de consórcio;0;0;103;103;
2018;1º;52568821;BRADESCO ADMINISTRADORA DE CONSÓRCIOS LTDA.;Irregularidades relacionadas à liberação do crédito;4;180;0;184;
2018;1º;52568821;BRADESCO ADMINISTRADORA DE CONSÓRCIOS LTDA.;Irregularidades relacionadas às condições para contemplação por lance ou sorteio;0;5;0;5;
2018;1º;52568821;BRADESCO ADMINISTRADORA DE CONSÓRCIOS LTDA.;Não fornecimento, remessa ou divulgação de documentos obrigatórios;0;1;0;1;
2018;1º;52568821;BRADESCO ADMINISTRADORA DE CONSÓRCIOS LTDA.;Operações de entidades não fiscalizadas pelo Banco Central;0;0;1;1;
2018;1º;52568821;BRADESCO ADMINISTRADORA DE CONSÓRCIOS LTDA.;Outras irregularidades;0;3;0;3;
2018;1º;52568821;BRADESCO ADMINISTRADORA DE CONSÓRCIOS LTDA.;Outras irregularidades relacionadas à Ouvidoria;0;3;0;3;
2018;1º;52568821;BRADESCO ADMINISTRADORA DE CONSÓRCIOS LTDA.;Prestação inadequada/insuficiente de informação;0;0;39;39;
2018;1º;52568821;BRADESCO ADMINISTRADORA DE CONSÓRCIOS LTDA.;Reclamações relacionadas a assuntos diversos;0;0;57;57;
2018;1º;52568821;BRADESCO ADMINISTRADORA DE CONSÓRCIOS LTDA.;Recusa ou demora no fornecimento de documentos (exceto demonstrativos obrigatórios);0;0;59;59;
2018;1º;73235962;BREITKOPF ADMINISTRADORA DE CONSÓRCIO LTDA.;Irregularidades relacionadas à liberação do crédito;0;1;0;1;
2018;1º;06046109;BRISA ADMINISTRADORA DE CONSORCIOS LTDA;Descumprimento de cláusulas referentes à devolução de valores;0;1;0;1;
2018;1º;45713971;BRQUALY ADMINISTRADORA DE CONSÓRCIOS LTDA.;Descumprimento de cláusulas referentes à devolução de valores;0;1;0;1;
2018;1º;45713971;BRQUALY ADMINISTRADORA DE CONSÓRCIOS LTDA.;Reclamações relacionadas a assuntos diversos;0;0;1;1;
2018;1º;05349595;CAIXA CONSÓRCIOS S.A ADMINISTRADORA DE CONSÓRCIOS;Ausência de transparência nas relações contratuais;0;0;3;3;
2018;1º;05349595;CAIXA CONSÓRCIOS S.A ADMINISTRADORA DE CONSÓRCIOS;Descumprimento de cláusulas referentes à devolução de valores;0;10;0;10;
2018;1º;05349595;CAIXA CONSÓRCIOS S.A ADMINISTRADORA DE CONSÓRCIOS;Descumprimento de obrigações previstas em contratos;6;11;0;17;
2018;1º;05349595;CAIXA CONSÓRCIOS S.A ADMINISTRADORA DE CONSÓRCIOS;Descumprimento de prazo de resposta a demanda;0;2;0;2;
2018;1º;05349595;CAIXA CONSÓRCIOS S.A ADMINISTRADORA DE CONSÓRCIOS;Dificuldade na liberação ou substituição de bem;0;0;5;5;
2018;1º;05349595;CAIXA CONSÓRCIOS S.A ADMINISTRADORA DE CONSÓRCIOS;Insatisfação com a resposta fornecida pela administradora de consórcio relativa à demanda registrada contra ela;0;9;0;9;
2018;1º;05349595;CAIXA CONSÓRCIOS S.A ADMINISTRADORA DE CONSÓRCIOS;Insatisfação por parte do cliente com o atendimento prestado pela administradora de consórcio;0;0;28;28;
2018;1º;05349595;CAIXA CONSÓRCIOS S.A ADMINISTRADORA DE CONSÓRCIOS;Irregularidades relacionadas à liberação do crédito;5;43;0;48;
2018;1º;05349595;CAIXA CONSÓRCIOS S.A ADMINISTRADORA DE CONSÓRCIOS;Irregularidades relacionadas às condições para contemplação por lance ou sorteio;1;5;0;6;
2018;1º;05349595;CAIXA CONSÓRCIOS S.A ADMINISTRADORA DE CONSÓRCIOS;Operações de entidades não fiscalizadas pelo Banco Central;0;0;2;2;
2018;1º;05349595;CAIXA CONSÓRCIOS S.A ADMINISTRADORA DE CONSÓRCIOS;Outras irregularidades;1;4;0;5;
2018;1º;05349595;CAIXA CONSÓRCIOS S.A ADMINISTRADORA DE CONSÓRCIOS;Prestação inadequada/insuficiente de informação;0;0;4;4;
2018;1º;05349595;CAIXA CONSÓRCIOS S.A ADMINISTRADORA DE CONSÓRCIOS;Publicidade enganosa;0;0;2;2;
2018;1º;05349595;CAIXA CONSÓRCIOS S.A ADMINISTRADORA DE CONSÓRCIOS;Reclamações relacionadas a assuntos diversos;0;0;24;24;
2018;1º;05349595;CAIXA CONSÓRCIOS S.A ADMINISTRADORA DE CONSÓRCIOS;Recusa ou demora no fornecimento de documentos (exceto demonstrativos obrigatórios);0;0;16;16;
2018;1º;68318773;CANOPUS ADMINISTRADORA DE CONSORCIOS S/A;Descumprimento de cláusulas referentes à devolução de valores;0;2;0;2;
2018;1º;68318773;CANOPUS ADMINISTRADORA DE CONSORCIOS S/A;Dificuldade na liberação ou substituição de bem;0;0;1;1;
2018;1º;68318773;CANOPUS ADMINISTRADORA DE CONSORCIOS S/A;Insatisfação com a resposta fornecida pela administradora de consórcio relativa à demanda registrada contra ela;0;1;0;1;
2018;1º;68318773;CANOPUS ADMINISTRADORA DE CONSORCIOS S/A;Insatisfação por parte do cliente com o atendimento prestado pela administradora de consórcio;0;0;3;3;
2018;1º;68318773;CANOPUS ADMINISTRADORA DE CONSORCIOS S/A;Irregularidades relacionadas às condições para contemplação por lance ou sorteio;0;1;0;1;
2018;1º;68318773;CANOPUS ADMINISTRADORA DE CONSORCIOS S/A;Outras irregularidades;0;3;0;3;
2018;1º;68318773;CANOPUS ADMINISTRADORA DE CONSORCIOS S/A;Prestação inadequada/insuficiente de informação;0;0;1;1;
2018;1º;68318773;CANOPUS ADMINISTRADORA DE CONSORCIOS S/A;Publicidade enganosa;0;0;2;2;
2018;1º;68318773;CANOPUS ADMINISTRADORA DE CONSORCIOS S/A;Reclamações relacionadas a assuntos diversos;0;0;2;2;
2018;1º;68318773;CANOPUS ADMINISTRADORA DE CONSORCIOS S/A;Recusa ou demora no fornecimento de documentos (exceto demonstrativos obrigatórios);0;0;1;1;
2018;1º;00266031;CICAL ADMINISTRADORA DE CONSÓRCIOS LTDA;Descumprimento de obrigações previstas em contratos;0;1;0;1;
2018;1º;13170428;CIMAVEL ADMINISTRADORA DE CONSÓRCIO LTDA.;Recusa ou demora no fornecimento de documentos (exceto demonstrativos obrigatórios);0;0;1;1;
2018;1º;59129403;CNF - ADMINISTRADORA DE CONSÓRCIOS NACIONAL LTDA.;Ausência de transparência nas relações contratuais;0;0;2;2;
2018;1º;59129403;CNF - ADMINISTRADORA DE CONSÓRCIOS NACIONAL LTDA.;Descumprimento de cláusulas referentes à devolução de valores;0;3;0;3;
2018;1º;59129403;CNF - ADMINISTRADORA DE CONSÓRCIOS NACIONAL LTDA.;Dificuldade na liberação ou substituição de bem;0;0;1;1;
2018;1º;59129403;CNF - ADMINISTRADORA DE CONSÓRCIOS NACIONAL LTDA.;Insatisfação com a resposta fornecida pela administradora de consórcio relativa à demanda registrada contra ela;0;1;0;1;
2018;1º;59129403;CNF - ADMINISTRADORA DE CONSÓRCIOS NACIONAL LTDA.;Insatisfação por parte do cliente com o atendimento prestado pela administradora de consórcio;0;0;3;3;
2018;1º;59129403;CNF - ADMINISTRADORA DE CONSÓRCIOS NACIONAL LTDA.;Irregularidades relacionadas à liberação do crédito;0;1;0;1;
2018;1º;59129403;CNF - ADMINISTRADORA DE CONSÓRCIOS NACIONAL LTDA.;Prestação inadequada/insuficiente de informação;0;0;1;1;
2018;1º;59129403;CNF - ADMINISTRADORA DE CONSÓRCIOS NACIONAL LTDA.;Reclamações relacionadas a assuntos diversos;0;0;2;2;
2018;1º;75770164;CONBR ADMINISTRADORA DE CONSÓRCIOS LTDA.;Insatisfação por parte do cliente com o atendimento prestado pela administradora de consórcio;0;0;1;1;
2018;1º;50827237;CONFIA ADMINISTRADORA DE CONSÓRCIO LTDA.;Irregularidades relacionadas à liberação do crédito;0;1;0;1;
2018;1º;81742223;CONSEG ADMINISTRADORA DE CONSÓRCIOS S/A;Descumprimento de cláusulas referentes à devolução de valores;0;1;0;1;
2018;1º;81742223;CONSEG ADMINISTRADORA DE CONSÓRCIOS S/A;Prestação inadequada/insuficiente de informação;0;0;1;1;
2018;1º;44196293;CONSHOP ADMINISTRADORA DE CONSORCIOS LTDA.;Insatisfação por parte do cliente com o atendimento prestado pela administradora de consórcio;0;0;1;1;
2018;1º;44196293;CONSHOP ADMINISTRADORA DE CONSORCIOS LTDA.;Irregularidades relacionadas às condições para contemplação por lance ou sorteio;0;1;0;1;
2018;1º;44196293;CONSHOP ADMINISTRADORA DE CONSORCIOS LTDA.;Outras irregularidades;0;1;0;1;
2018;1º;44196293;CONSHOP ADMINISTRADORA DE CONSORCIOS LTDA.;Reclamações relacionadas a assuntos diversos;0;0;1;1;
2018;1º;47658539;CONSÓRCIO NACIONAL VOLKSWAGEN - ADMINISTRADORA DE CONSÓRCIO LTDA.;Ausência de transparência nas relações contratuais;0;0;13;13;
2018;1º;47658539;CONSÓRCIO NACIONAL VOLKSWAGEN - ADMINISTRADORA DE CONSÓRCIO LTDA.;Cobrança irregular de tarifa pela emissão de boletos, carnês e assemelhados;0;1;0;1;
2018;1º;47658539;CONSÓRCIO NACIONAL VOLKSWAGEN - ADMINISTRADORA DE CONSÓRCIO LTDA.;Descumprimento de cláusulas referentes à devolução de valores;3;31;0;34;
2018;1º;47658539;CONSÓRCIO NACIONAL VOLKSWAGEN - ADMINISTRADORA DE CONSÓRCIO LTDA.;Descumprimento de obrigações previstas em contratos;0;6;0;6;
2018;1º;47658539;CONSÓRCIO NACIONAL VOLKSWAGEN - ADMINISTRADORA DE CONSÓRCIO LTDA.;Dificuldade na liberação ou substituição de bem;0;0;8;8;
2018;1º;47658539;CONSÓRCIO NACIONAL VOLKSWAGEN - ADMINISTRADORA DE CONSÓRCIO LTDA.;Insatisfação com a resposta fornecida pela administradora de consórcio relativa à demanda registrada contra ela;0;7;0;7;
2018;1º;47658539;CONSÓRCIO NACIONAL VOLKSWAGEN - ADMINISTRADORA DE CONSÓRCIO LTDA.;Insatisfação por parte do cliente com o atendimento prestado pela administradora de consórcio;0;0;21;21;
2018;1º;47658539;CONSÓRCIO NACIONAL VOLKSWAGEN - ADMINISTRADORA DE CONSÓRCIO LTDA.;Irregularidades relacionadas à liberação do crédito;2;27;0;29;
2018;1º;47658539;CONSÓRCIO NACIONAL VOLKSWAGEN - ADMINISTRADORA DE CONSÓRCIO LTDA.;Irregularidades relacionadas às condições para contemplação por lance ou sorteio;0;11;0;11;
2018;1º;47658539;CONSÓRCIO NACIONAL VOLKSWAGEN - ADMINISTRADORA DE CONSÓRCIO LTDA.;Não fornecimento, remessa ou divulgação de documentos obrigatórios;0;1;0;1;
2018;1º;47658539;CONSÓRCIO NACIONAL VOLKSWAGEN - ADMINISTRADORA DE CONSÓRCIO LTDA.;Outras irregularidades;0;1;0;1;
2018;1º;47658539;CONSÓRCIO NACIONAL VOLKSWAGEN - ADMINISTRADORA DE CONSÓRCIO LTDA.;Prestação inadequada/insuficiente de informação;0;0;10;10;
2018;1º;47658539;CONSÓRCIO NACIONAL VOLKSWAGEN - ADMINISTRADORA DE CONSÓRCIO LTDA.;Publicidade enganosa;0;0;3;3;
2018;1º;47658539;CONSÓRCIO NACIONAL VOLKSWAGEN - ADMINISTRADORA DE CONSÓRCIO LTDA.;Reclamações relacionadas a assuntos diversos;0;0;19;19;
2018;1º;47658539;CONSÓRCIO NACIONAL VOLKSWAGEN - ADMINISTRADORA DE CONSÓRCIO LTDA.;Recusa ou demora no fornecimento de documentos (exceto demonstrativos obrigatórios);0;0;10;10;
2018;1º;58919903;CONVEF ADMINISTRADORA DE CONSÓRCIOS LTDA.;Descumprimento de cláusulas referentes à devolução de valores;0;4;0;4;
2018;1º;58919903;CONVEF ADMINISTRADORA DE CONSÓRCIOS LTDA.;Descumprimento de obrigações previstas em contratos;0;1;0;1;
2018;1º;58919903;CONVEF ADMINISTRADORA DE CONSÓRCIOS LTDA.;Dificuldade na liberação ou substituição de bem;0;0;1;1;
2018;1º;58919903;CONVEF ADMINISTRADORA DE CONSÓRCIOS LTDA.;Irregularidades relacionadas à liberação do crédito;0;1;0;1;
2018;1º;58919903;CONVEF ADMINISTRADORA DE CONSÓRCIOS LTDA.;Prestação inadequada/insuficiente de informação;0;0;3;3;
2018;1º;58919903;CONVEF ADMINISTRADORA DE CONSÓRCIOS LTDA.;Reclamações relacionadas a assuntos diversos;0;0;1;1;
2018;1º;58919903;CONVEF ADMINISTRADORA DE CONSÓRCIOS LTDA.;Recusa ou demora no fornecimento de documentos (exceto demonstrativos obrigatórios);0;0;1;1;
2018;1º;61550836;COOPERATIVA MISTA JOCKEY CLUB DE SAO PAULO;Descumprimento de obrigações previstas em contratos;0;1;0;1;
2018;1º;61550836;COOPERATIVA MISTA JOCKEY CLUB DE SAO PAULO;Insatisfação com a resposta fornecida pela administradora de consórcio relativa à demanda registrada contra ela;0;1;0;1;
2018;1º;61550836;COOPERATIVA MISTA JOCKEY CLUB DE SAO PAULO;Outras irregularidades;0;20;0;20;
2018;1º;61550836;COOPERATIVA MISTA JOCKEY CLUB DE SAO PAULO;Prestação inadequada/insuficiente de informação;0;0;1;1;
2018;1º;61550836;COOPERATIVA MISTA JOCKEY CLUB DE SAO PAULO;Publicidade enganosa;0;0;1;1;
2018;1º;59395061;DISAL ADMINISTRADORA DE CONSÓRCIOS LTDA;Ausência de transparência nas relações contratuais;0;0;5;5;
2018;1º;59395061;DISAL ADMINISTRADORA DE CONSÓRCIOS LTDA;Descumprimento de cláusulas referentes à devolução de valores;0;15;0;15;
2018;1º;59395061;DISAL ADMINISTRADORA DE CONSÓRCIOS LTDA;Descumprimento de obrigações previstas em contratos;0;9;0;9;
2018;1º;59395061;DISAL ADMINISTRADORA DE CONSÓRCIOS LTDA;Descumprimento de prazo de resposta a demanda;0;1;0;1;
2018;1º;59395061;DISAL ADMINISTRADORA DE CONSÓRCIOS LTDA;Descumprimento de prazo para apresentação de resposta conclusiva pela Ouvidoria;0;1;0;1;
2018;1º;59395061;DISAL ADMINISTRADORA DE CONSÓRCIOS LTDA;Dificuldade na liberação ou substituição de bem;0;0;2;2;
2018;1º;59395061;DISAL ADMINISTRADORA DE CONSÓRCIOS LTDA;Insatisfação com a resposta fornecida pela administradora de consórcio relativa à demanda registrada contra ela;1;3;0;4;
2018;1º;59395061;DISAL ADMINISTRADORA DE CONSÓRCIOS LTDA;Insatisfação por parte do cliente com o atendimento prestado pela administradora de consórcio;0;0;7;7;
2018;1º;59395061;DISAL ADMINISTRADORA DE CONSÓRCIOS LTDA;Irregularidades relacionadas à liberação do crédito;0;15;0;15;
2018;1º;59395061;DISAL ADMINISTRADORA DE CONSÓRCIOS LTDA;Irregularidades relacionadas às condições para contemplação por lance ou sorteio;0;3;0;3;
2018;1º;59395061;DISAL ADMINISTRADORA DE CONSÓRCIOS LTDA;Outras irregularidades;1;5;0;6;
2018;1º;59395061;DISAL ADMINISTRADORA DE CONSÓRCIOS LTDA;Prestação inadequada/insuficiente de informação;0;0;7;7;
2018;1º;59395061;DISAL ADMINISTRADORA DE CONSÓRCIOS LTDA;Publicidade enganosa;0;0;1;1;
2018;1º;59395061;DISAL ADMINISTRADORA DE CONSÓRCIOS LTDA;Reclamações relacionadas a assuntos diversos;0;0;9;9;
2018;1º;59395061;DISAL ADMINISTRADORA DE CONSÓRCIOS LTDA;Recusa ou demora no fornecimento de documentos (exceto demonstrativos obrigatórios);0;0;3;3;
2018;1º;08570707;ELDORADO ADMINISTRADORA DE CONSORCIO LTDA;Irregularidades relacionadas à liberação do crédito;0;1;0;1;
2018;1º;58113812;EMBRACON ADMINISTRADORA DE CONSÓRCIO LTDA;Ausência de transparência nas relações contratuais;0;0;7;7;
2018;1º;58113812;EMBRACON ADMINISTRADORA DE CONSÓRCIO LTDA;Descumprimento de cláusulas referentes à devolução de valores;0;20;0;20;
2018;1º;58113812;EMBRACON ADMINISTRADORA DE CONSÓRCIO LTDA;Descumprimento de obrigações previstas em contratos;0;5;0;5;
2018;1º;58113812;EMBRACON ADMINISTRADORA DE CONSÓRCIO LTDA;Dificuldade na liberação ou substituição de bem;0;0;1;1;
2018;1º;58113812;EMBRACON ADMINISTRADORA DE CONSÓRCIO LTDA;Insatisfação com a resposta fornecida pela administradora de consórcio relativa à demanda registrada contra ela;0;4;0;4;
2018;1º;58113812;EMBRACON ADMINISTRADORA DE CONSÓRCIO LTDA;Insatisfação por parte do cliente com o atendimento prestado pela administradora de consórcio;0;0;6;6;
2018;1º;58113812;EMBRACON ADMINISTRADORA DE CONSÓRCIO LTDA;Irregularidades relacionadas à liberação do crédito;0;25;0;25;
2018;1º;58113812;EMBRACON ADMINISTRADORA DE CONSÓRCIO LTDA;Irregularidades relacionadas às condições para contemplação por lance ou sorteio;0;8;0;8;
2018;1º;58113812;EMBRACON ADMINISTRADORA DE CONSÓRCIO LTDA;Outras irregularidades;1;1;0;2;
2018;1º;58113812;EMBRACON ADMINISTRADORA DE CONSÓRCIO LTDA;Prestação inadequada/insuficiente de informação;0;0;34;34;
2018;1º;58113812;EMBRACON ADMINISTRADORA DE CONSÓRCIO LTDA;Publicidade enganosa;0;0;10;10;
2018;1º;58113812;EMBRACON ADMINISTRADORA DE CONSÓRCIO LTDA;Reclamações relacionadas a assuntos diversos;0;0;7;7;
2018;1º;58113812;EMBRACON ADMINISTRADORA DE CONSÓRCIO LTDA;Recusa ou demora no fornecimento de documentos (exceto demonstrativos obrigatórios);0;0;4;4;
2018;1º;91107581;FARROUPILHA ADMINISTRADORA DE CONSÓRCIOS LTDA.;Descumprimento de cláusulas referentes à devolução de valores;0;2;0;2;
2018;1º;91107581;FARROUPILHA ADMINISTRADORA DE CONSÓRCIOS LTDA.;Descumprimento de obrigações previstas em contratos;0;1;0;1;
2018;1º;91107581;FARROUPILHA ADMINISTRADORA DE CONSÓRCIOS LTDA.;Descumprimento de prazo de resposta a demanda;1;0;0;1;
2018;1º;78688462;FIPAL ADMINISTRADORA DE CONSÓRCIOS LTDA;Irregularidades relacionadas às condições para contemplação por lance ou sorteio;0;1;0;1;
2018;1º;00643742;FUNDACAO HABITACIONAL DO EXERCITO - FHE;Cobrança irregular de tarifa pela emissão de boletos, carnês e assemelhados;0;1;0;1;
2018;1º;00643742;FUNDACAO HABITACIONAL DO EXERCITO - FHE;Insatisfação com a resposta fornecida pela administradora de consórcio relativa à demanda registrada contra ela;0;1;0;1;
2018;1º;00643742;FUNDACAO HABITACIONAL DO EXERCITO - FHE;Insatisfação por parte do cliente com o atendimento prestado pela administradora de consórcio;0;0;1;1;
2018;1º;00643742;FUNDACAO HABITACIONAL DO EXERCITO - FHE;Prestação inadequada/insuficiente de informação;0;0;5;5;
2018;1º;00643742;FUNDACAO HABITACIONAL DO EXERCITO - FHE;Reclamações relacionadas a assuntos diversos;0;0;4;4;
2018;1º;00643742;FUNDACAO HABITACIONAL DO EXERCITO - FHE;Recusa ou demora no fornecimento de documentos (exceto demonstrativos obrigatórios);0;0;2;2;
2018;1º;47820097;GAPLAN ADMINISTRADORA DE CONSÓRCIO LTDA.;Descumprimento de obrigações previstas em contratos;0;1;0;1;
2018;1º;85322204;GLOBO ADMINISTRADORA DE CONSÓRCIOS LTDA.;Prestação inadequada/insuficiente de informação;0;0;1;1;
2018;1º;49937055;GMAC ADMINISTRADORA DE CONSORCIOS LTDA;Ausência de transparência nas relações contratuais;0;0;7;7;
2018;1º;49937055;GMAC ADMINISTRADORA DE CONSORCIOS LTDA;Descumprimento de cláusulas referentes à devolução de valores;1;11;0;12;
2018;1º;49937055;GMAC ADMINISTRADORA DE CONSORCIOS LTDA;Descumprimento de obrigações previstas em contratos;2;6;0;8;
2018;1º;49937055;GMAC ADMINISTRADORA DE CONSORCIOS LTDA;Dificuldade na liberação ou substituição de bem;0;0;6;6;
2018;1º;49937055;GMAC ADMINISTRADORA DE CONSORCIOS LTDA;Insatisfação com a resposta fornecida pela administradora de consórcio relativa à demanda registrada contra ela;0;8;0;8;
2018;1º;49937055;GMAC ADMINISTRADORA DE CONSORCIOS LTDA;Insatisfação por parte do cliente com o atendimento prestado pela administradora de consórcio;0;0;9;9;
2018;1º;49937055;GMAC ADMINISTRADORA DE CONSORCIOS LTDA;Irregularidades relacionadas à liberação do crédito;0;23;0;23;
2018;1º;49937055;GMAC ADMINISTRADORA DE CONSORCIOS LTDA;Irregularidades relacionadas às condições para contemplação por lance ou sorteio;0;3;0;3;
2018;1º;49937055;GMAC ADMINISTRADORA DE CONSORCIOS LTDA;Prestação inadequada/insuficiente de informação;0;0;3;3;
2018;1º;49937055;GMAC ADMINISTRADORA DE CONSORCIOS LTDA;Reclamações relacionadas a assuntos diversos;0;0;12;12;
2018;1º;49937055;GMAC ADMINISTRADORA DE CONSORCIOS LTDA;Recusa ou demora no fornecimento de documentos (exceto demonstrativos obrigatórios);0;0;10;10;
2018;1º;02798858;GOVESA ADMINISTRADORA DE CONSÓRCIOS LTDA;Irregularidades relacionadas à liberação do crédito;0;1;0;1;
2018;1º;02798858;GOVESA ADMINISTRADORA DE CONSÓRCIOS LTDA;Irregularidades relacionadas às condições para contemplação por lance ou sorteio;0;1;0;1;
2018;1º;91338228;GRAVEL ADMINISTRADORA DE CONSÓRCIOS LTDA.;Irregularidades relacionadas às condições para contemplação por lance ou sorteio;0;1;0;1;
2018;1º;26228270;GROSCON ADMINISTRADORA DE CONSORCIOS LTDA.;Ausência de transparência nas relações contratuais;0;0;1;1;
2018;1º;26228270;GROSCON ADMINISTRADORA DE CONSORCIOS LTDA.;Insatisfação com a resposta fornecida pela administradora de consórcio relativa à demanda registrada contra ela;0;1;0;1;
2018;1º;26253658;GUARAPIRANGA VEÍCULOS ADMINISTRADORA DE CONSÓRCIOS LTDA.;Irregularidades relacionadas à liberação do crédito;0;1;0;1;
2018;1º;03586655;H. ADMINISTRADORA DE CONSÓRCIOS LTDA;Descumprimento de cláusulas referentes à devolução de valores;0;1;0;1;
2018;1º;73516106;HS ADMINISTRADORA DE CONSÓRCIOS LTDA;Ausência de transparência nas relações contratuais;0;0;1;1;
2018;1º;73516106;HS ADMINISTRADORA DE CONSÓRCIOS LTDA;Descumprimento de cláusulas referentes à devolução de valores;0;1;0;1;
2018;1º;73516106;HS ADMINISTRADORA DE CONSÓRCIOS LTDA;Insatisfação por parte do cliente com o atendimento prestado pela administradora de consórcio;0;0;2;2;
2018;1º;73516106;HS ADMINISTRADORA DE CONSÓRCIOS LTDA;Irregularidades relacionadas à liberação do crédito;0;5;0;5;
2018;1º;73516106;HS ADMINISTRADORA DE CONSÓRCIOS LTDA;Prestação inadequada/insuficiente de informação;0;0;4;4;
2018;1º;06181431;ITAUNA ADMINISTRADORA DE CONSORCIO LTDA;Descumprimento de obrigações previstas em contratos;1;0;0;1;
2018;1º;06181431;ITAUNA ADMINISTRADORA DE CONSORCIO LTDA;Irregularidades relacionadas à liberação do crédito;0;2;0;2;
2018;1º;06181431;ITAUNA ADMINISTRADORA DE CONSORCIO LTDA;Reclamações relacionadas a assuntos diversos;0;0;1;1;
2018;1º;00000776;ITAÚ ADMINISTRADORA DE CONSÓRCIOS LTDA.;Ausência de transparência nas relações contratuais;0;0;7;7;
2018;1º;00000776;ITAÚ ADMINISTRADORA DE CONSÓRCIOS LTDA.;Cobrança irregular de tarifa pela emissão de boletos, carnês e assemelhados;0;2;0;2;
2018;1º;00000776;ITAÚ ADMINISTRADORA DE CONSÓRCIOS LTDA.;Descumprimento de cláusulas referentes à devolução de valores;1;51;0;52;
2018;1º;00000776;ITAÚ ADMINISTRADORA DE CONSÓRCIOS LTDA.;Descumprimento de obrigações previstas em contratos;5;31;0;36;
2018;1º;00000776;ITAÚ ADMINISTRADORA DE CONSÓRCIOS LTDA.;Descumprimento de prazo de resposta a demanda;0;5;0;5;
2018;1º;00000776;ITAÚ ADMINISTRADORA DE CONSÓRCIOS LTDA.;Dificuldade na liberação ou substituição de bem;0;0;15;15;
2018;1º;00000776;ITAÚ ADMINISTRADORA DE CONSÓRCIOS LTDA.;Insatisfação com a resposta fornecida pela administradora de consórcio relativa à demanda registrada contra ela;0;2;0;2;
2018;1º;00000776;ITAÚ ADMINISTRADORA DE CONSÓRCIOS LTDA.;Insatisfação por parte do cliente com o atendimento prestado pela administradora de consórcio;0;0;18;18;
2018;1º;00000776;ITAÚ ADMINISTRADORA DE CONSÓRCIOS LTDA.;Irregularidades relacionadas à liberação do crédito;1;63;0;64;
2018;1º;00000776;ITAÚ ADMINISTRADORA DE CONSÓRCIOS LTDA.;Irregularidades relacionadas às condições para contemplação por lance ou sorteio;0;10;0;10;
2018;1º;00000776;ITAÚ ADMINISTRADORA DE CONSÓRCIOS LTDA.;Outras irregularidades;0;1;0;1;
2018;1º;00000776;ITAÚ ADMINISTRADORA DE CONSÓRCIOS LTDA.;Prestação inadequada/insuficiente de informação;0;0;27;27;
2018;1º;00000776;ITAÚ ADMINISTRADORA DE CONSÓRCIOS LTDA.;Publicidade enganosa;0;0;1;1;
2018;1º;00000776;ITAÚ ADMINISTRADORA DE CONSÓRCIOS LTDA.;Reclamações relacionadas a assuntos diversos;0;0;32;32;
2018;1º;00000776;ITAÚ ADMINISTRADORA DE CONSÓRCIOS LTDA.;Recusa ou demora no fornecimento de documentos (exceto demonstrativos obrigatórios);0;0;19;19;
2018;1º;42421776;ITAÚ UNIBANCO VEÍCULOS ADMINISTRADORA DE CONSÓRCIOS LTDA.;Ausência de transparência nas relações contratuais;0;0;1;1;
2018;1º;42421776;ITAÚ UNIBANCO VEÍCULOS ADMINISTRADORA DE CONSÓRCIOS LTDA.;Descumprimento de cláusulas referentes à devolução de valores;2;13;0;15;
2018;1º;42421776;ITAÚ UNIBANCO VEÍCULOS ADMINISTRADORA DE CONSÓRCIOS LTDA.;Descumprimento de obrigações previstas em contratos;4;2;0;6;
2018;1º;42421776;ITAÚ UNIBANCO VEÍCULOS ADMINISTRADORA DE CONSÓRCIOS LTDA.;Descumprimento de prazo de resposta a demanda;0;1;0;1;
2018;1º;42421776;ITAÚ UNIBANCO VEÍCULOS ADMINISTRADORA DE CONSÓRCIOS LTDA.;Dificuldade na liberação ou substituição de bem;0;0;2;2;
2018;1º;42421776;ITAÚ UNIBANCO VEÍCULOS ADMINISTRADORA DE CONSÓRCIOS LTDA.;Insatisfação com a resposta fornecida pela administradora de consórcio relativa à demanda registrada contra ela;1;1;0;2;
2018;1º;42421776;ITAÚ UNIBANCO VEÍCULOS ADMINISTRADORA DE CONSÓRCIOS LTDA.;Insatisfação por parte do cliente com o atendimento prestado pela administradora de consórcio;0;0;5;5;
2018;1º;42421776;ITAÚ UNIBANCO VEÍCULOS ADMINISTRADORA DE CONSÓRCIOS LTDA.;Irregularidades relacionadas à liberação do crédito;0;10;0;10;
2018;1º;42421776;ITAÚ UNIBANCO VEÍCULOS ADMINISTRADORA DE CONSÓRCIOS LTDA.;Irregularidades relacionadas às condições para contemplação por lance ou sorteio;0;3;0;3;
2018;1º;42421776;ITAÚ UNIBANCO VEÍCULOS ADMINISTRADORA DE CONSÓRCIOS LTDA.;Não fornecimento, remessa ou divulgação de documentos obrigatórios;1;0;0;1;
2018;1º;42421776;ITAÚ UNIBANCO VEÍCULOS ADMINISTRADORA DE CONSÓRCIOS LTDA.;Outras irregularidades;0;1;0;1;
2018;1º;42421776;ITAÚ UNIBANCO VEÍCULOS ADMINISTRADORA DE CONSÓRCIOS LTDA.;Prestação inadequada/insuficiente de informação;0;0;2;2;
2018;1º;42421776;ITAÚ UNIBANCO VEÍCULOS ADMINISTRADORA DE CONSÓRCIOS LTDA.;Reclamações relacionadas a assuntos diversos;0;0;2;2;
2018;1º;42421776;ITAÚ UNIBANCO VEÍCULOS ADMINISTRADORA DE CONSÓRCIOS LTDA.;Recusa ou demora no fornecimento de documentos (exceto demonstrativos obrigatórios);0;0;5;5;
2018;1º;60250776;LUIZA ADMINISTRADORA DE CONSÓRCIOS LTDA;Descumprimento de cláusulas referentes à devolução de valores;0;1;0;1;
2018;1º;60250776;LUIZA ADMINISTRADORA DE CONSÓRCIOS LTDA;Descumprimento de obrigações previstas em contratos;0;1;0;1;
2018;1º;60250776;LUIZA ADMINISTRADORA DE CONSÓRCIOS LTDA;Descumprimento de prazo de resposta a demanda;0;3;0;3;
2018;1º;60250776;LUIZA ADMINISTRADORA DE CONSÓRCIOS LTDA;Golpe;0;0;1;1;
2018;1º;60250776;LUIZA ADMINISTRADORA DE CONSÓRCIOS LTDA;Insatisfação com a resposta fornecida pela administradora de consórcio relativa à demanda registrada contra ela;0;1;0;1;
2018;1º;60250776;LUIZA ADMINISTRADORA DE CONSÓRCIOS LTDA;Outras irregularidades;0;2;0;2;
2018;1º;60250776;LUIZA ADMINISTRADORA DE CONSÓRCIOS LTDA;Prestação inadequada/insuficiente de informação;0;0;3;3;
2018;1º;60250776;LUIZA ADMINISTRADORA DE CONSÓRCIOS LTDA;Reclamações relacionadas a assuntos diversos;0;0;2;2;
2018;1º;04250224;MAGGI ADMINISTRADORA DE CONSÓRCIOS LTDA;Ausência de transparência nas relações contratuais;0;0;1;1;
2018;1º;04250224;MAGGI ADMINISTRADORA DE CONSÓRCIOS LTDA;Descumprimento de obrigações previstas em contratos;0;1;0;1;
2018;1º;04250224;MAGGI ADMINISTRADORA DE CONSÓRCIOS LTDA;Insatisfação com a resposta fornecida pela administradora de consórcio relativa à demanda registrada contra ela;0;1;0;1;
2018;1º;04250224;MAGGI ADMINISTRADORA DE CONSÓRCIOS LTDA;Insatisfação por parte do cliente com o atendimento prestado pela administradora de consórcio;0;0;1;1;
2018;1º;04250224;MAGGI ADMINISTRADORA DE CONSÓRCIOS LTDA;Irregularidades relacionadas à liberação do crédito;0;3;0;3;
2018;1º;04250224;MAGGI ADMINISTRADORA DE CONSÓRCIOS LTDA;Outras irregularidades;0;1;0;1;
2018;1º;04250224;MAGGI ADMINISTRADORA DE CONSÓRCIOS LTDA;Prestação inadequada/insuficiente de informação;0;0;2;2;
2018;1º;04250224;MAGGI ADMINISTRADORA DE CONSÓRCIOS LTDA;Reclamações relacionadas a assuntos diversos;0;0;1;1;
2018;1º;45793395;MASSEY FERGUSON ADMINISTRADORA DE CONSÓRCIOS LTDA;Reclamações relacionadas a assuntos diversos;0;0;1;1;
2018;1º;46349106;MERCABENCO MERCANTIL E ADMINISTRADORA DE BENS E CONSÓRCIOS LTDA.;Reclamações relacionadas a assuntos diversos;0;0;2;2;
2018;1º;05126027;MOTOASA ADMINISTRADORA DE CONSÓRCIOS LTDA.;Descumprimento de cláusulas referentes à devolução de valores;0;1;0;1;
2018;1º;04124922;MULTIMARCAS ADMINISTRADORA DE CONSORCIOS LTDA.;Ausência de transparência nas relações contratuais;0;0;3;3;
2018;1º;04124922;MULTIMARCAS ADMINISTRADORA DE CONSORCIOS LTDA.;Descumprimento de cláusulas referentes à devolução de valores;0;1;0;1;
2018;1º;04124922;MULTIMARCAS ADMINISTRADORA DE CONSORCIOS LTDA.;Descumprimento de obrigações previstas em contratos;1;1;0;2;
2018;1º;04124922;MULTIMARCAS ADMINISTRADORA DE CONSORCIOS LTDA.;Insatisfação com a resposta fornecida pela administradora de consórcio relativa à demanda registrada contra ela;0;2;0;2;
2018;1º;04124922;MULTIMARCAS ADMINISTRADORA DE CONSORCIOS LTDA.;Insatisfação por parte do cliente com o atendimento prestado pela administradora de consórcio;0;0;1;1;
2018;1º;04124922;MULTIMARCAS ADMINISTRADORA DE CONSORCIOS LTDA.;Irregularidades relacionadas às condições para contemplação por lance ou sorteio;0;1;0;1;
2018;1º;04124922;MULTIMARCAS ADMINISTRADORA DE CONSORCIOS LTDA.;Outras irregularidades;2;14;0;16;
2018;1º;04124922;MULTIMARCAS ADMINISTRADORA DE CONSORCIOS LTDA.;Prestação inadequada/insuficiente de informação;0;0;4;4;
2018;1º;04124922;MULTIMARCAS ADMINISTRADORA DE CONSORCIOS LTDA.;Publicidade enganosa;0;0;11;11;
2018;1º;04124922;MULTIMARCAS ADMINISTRADORA DE CONSORCIOS LTDA.;Reclamações relacionadas a assuntos diversos;0;0;3;3;
2018;1º;33636838;NASA ADMINISTRADORA DE CONSÓRCIO LTDA;Reclamações relacionadas a assuntos diversos;0;0;1;1;
2018;1º;50533876;PAN ADMINISTRADORA DE CONSORCIO LTDA;;0;0;1;1;
2018;1º;50533876;PAN ADMINISTRADORA DE CONSORCIO LTDA;Cobrança irregular de tarifa pela emissão de boletos, carnês e assemelhados;0;1;0;1;
2018;1º;50533876;PAN ADMINISTRADORA DE CONSORCIO LTDA;Descumprimento de cláusulas referentes à devolução de valores;0;4;0;4;
2018;1º;50533876;PAN ADMINISTRADORA DE CONSORCIO LTDA;Insatisfação com a resposta fornecida pela administradora de consórcio relativa à demanda registrada contra ela;2;8;0;10;
2018;1º;50533876;PAN ADMINISTRADORA DE CONSORCIO LTDA;Insatisfação por parte do cliente com o atendimento prestado pela administradora de consórcio;0;0;5;5;
2018;1º;50533876;PAN ADMINISTRADORA DE CONSORCIO LTDA;Irregularidades relacionadas à liberação do crédito;0;2;0;2;
2018;1º;50533876;PAN ADMINISTRADORA DE CONSORCIO LTDA;Irregularidades relacionadas às condições para contemplação por lance ou sorteio;0;2;0;2;
2018;1º;50533876;PAN ADMINISTRADORA DE CONSORCIO LTDA;Prestação inadequada/insuficiente de informação;0;0;15;15;
2018;1º;50533876;PAN ADMINISTRADORA DE CONSORCIO LTDA;Publicidade enganosa;0;0;3;3;
2018;1º;50533876;PAN ADMINISTRADORA DE CONSORCIO LTDA;Reclamações relacionadas a assuntos diversos;0;0;5;5;
2018;1º;50533876;PAN ADMINISTRADORA DE CONSORCIO LTDA;Recusa ou demora no fornecimento de documentos (exceto demonstrativos obrigatórios);0;0;6;6;
2018;1º;16551061;PONTA ADMINISTRADORA DE CONSORCIOS LTDA;Ausência de transparência nas relações contratuais;0;0;2;2;
2018;1º;16551061;PONTA ADMINISTRADORA DE CONSORCIOS LTDA;Descumprimento de obrigações previstas em contratos;0;1;0;1;
2018;1º;16551061;PONTA ADMINISTRADORA DE CONSORCIOS LTDA;Dificuldade na liberação ou substituição de bem;0;0;1;1;
2018;1º;16551061;PONTA ADMINISTRADORA DE CONSORCIOS LTDA;Insatisfação com a resposta fornecida pela administradora de consórcio relativa à demanda registrada contra ela;0;1;0;1;
2018;1º;16551061;PONTA ADMINISTRADORA DE CONSORCIOS LTDA;Insatisfação por parte do cliente com o atendimento prestado pela administradora de consórcio;0;0;1;1;
2018;1º;16551061;PONTA ADMINISTRADORA DE CONSORCIOS LTDA;Irregularidades relacionadas à liberação do crédito;0;9;0;9;
2018;1º;16551061;PONTA ADMINISTRADORA DE CONSORCIOS LTDA;Irregularidades relacionadas às condições para contemplação por lance ou sorteio;0;1;0;1;
2018;1º;16551061;PONTA ADMINISTRADORA DE CONSORCIOS LTDA;Prestação inadequada/insuficiente de informação;0;0;1;1;
2018;1º;16551061;PONTA ADMINISTRADORA DE CONSORCIOS LTDA;Reclamações relacionadas a assuntos diversos;0;0;4;4;
2018;1º;48041735;PORTO SEGURO ADMINISTRADORA DE CONSÓRCIOS LTDA;Ausência de transparência nas relações contratuais;0;0;2;2;
2018;1º;48041735;PORTO SEGURO ADMINISTRADORA DE CONSÓRCIOS LTDA;Descumprimento de cláusulas referentes à devolução de valores;0;7;0;7;
2018;1º;48041735;PORTO SEGURO ADMINISTRADORA DE CONSÓRCIOS LTDA;Descumprimento de obrigações previstas em contratos;0;4;0;4;
2018;1º;48041735;PORTO SEGURO ADMINISTRADORA DE CONSÓRCIOS LTDA;Dificuldade na liberação ou substituição de bem;0;0;3;3;
2018;1º;48041735;PORTO SEGURO ADMINISTRADORA DE CONSÓRCIOS LTDA;Insatisfação com a resposta fornecida pela administradora de consórcio relativa à demanda registrada contra ela;0;3;0;3;
2018;1º;48041735;PORTO SEGURO ADMINISTRADORA DE CONSÓRCIOS LTDA;Insatisfação por parte do cliente com o atendimento prestado pela administradora de consórcio;0;0;2;2;
2018;1º;48041735;PORTO SEGURO ADMINISTRADORA DE CONSÓRCIOS LTDA;Irregularidades relacionadas à liberação do crédito;0;7;0;7;
2018;1º;48041735;PORTO SEGURO ADMINISTRADORA DE CONSÓRCIOS LTDA;Outras irregularidades;0;1;0;1;
2018;1º;48041735;PORTO SEGURO ADMINISTRADORA DE CONSÓRCIOS LTDA;Prestação inadequada/insuficiente de informação;0;0;7;7;
2018;1º;48041735;PORTO SEGURO ADMINISTRADORA DE CONSÓRCIOS LTDA;Reclamações relacionadas a assuntos diversos;0;0;13;13;
2018;1º;48041735;PORTO SEGURO ADMINISTRADORA DE CONSÓRCIOS LTDA;Recusa ou demora no fornecimento de documentos (exceto demonstrativos obrigatórios);0;0;7;7;
2018;1º;87433413;PORTOBENS ADMINISTRADORA DE CONSORCIOS LTDA;Cobrança irregular de tarifa pela emissão de boletos, carnês e assemelhados;0;1;0;1;
2018;1º;87433413;PORTOBENS ADMINISTRADORA DE CONSORCIOS LTDA;Dificuldade na liberação ou substituição de bem;0;0;1;1;
2018;1º;87433413;PORTOBENS ADMINISTRADORA DE CONSORCIOS LTDA;Insatisfação com a resposta fornecida pela administradora de consórcio relativa à demanda registrada contra ela;0;2;0;2;
2018;1º;87433413;PORTOBENS ADMINISTRADORA DE CONSORCIOS LTDA;Irregularidades relacionadas à liberação do crédito;0;1;0;1;
2018;1º;87433413;PORTOBENS ADMINISTRADORA DE CONSORCIOS LTDA;Prestação inadequada/insuficiente de informação;0;0;1;1;
2018;1º;87433413;PORTOBENS ADMINISTRADORA DE CONSORCIOS LTDA;Reclamações relacionadas a assuntos diversos;0;0;1;1;
2018;1º;51597300;PRIMO ROSSI ADMINISTRADORA DE CONSÓRCIO LTDA.;Cobrança irregular de tarifa pela emissão de boletos, carnês e assemelhados;0;1;0;1;
2018;1º;51597300;PRIMO ROSSI ADMINISTRADORA DE CONSÓRCIO LTDA.;Descumprimento de cláusulas referentes à devolução de valores;0;2;0;2;
2018;1º;51597300;PRIMO ROSSI ADMINISTRADORA DE CONSÓRCIO LTDA.;Descumprimento de obrigações previstas em contratos;1;3;0;4;
2018;1º;51597300;PRIMO ROSSI ADMINISTRADORA DE CONSÓRCIO LTDA.;Dificuldade na liberação ou substituição de bem;0;0;2;2;
2018;1º;51597300;PRIMO ROSSI ADMINISTRADORA DE CONSÓRCIO LTDA.;Insatisfação com a resposta fornecida pela administradora de consórcio relativa à demanda registrada contra ela;0;3;0;3;
2018;1º;51597300;PRIMO ROSSI ADMINISTRADORA DE CONSÓRCIO LTDA.;Insatisfação por parte do cliente com o atendimento prestado pela administradora de consórcio;0;0;5;5;
2018;1º;51597300;PRIMO ROSSI ADMINISTRADORA DE CONSÓRCIO LTDA.;Irregularidades relacionadas à liberação do crédito;0;1;0;1;
2018;1º;51597300;PRIMO ROSSI ADMINISTRADORA DE CONSÓRCIO LTDA.;Outras irregularidades;1;0;0;1;
2018;1º;51597300;PRIMO ROSSI ADMINISTRADORA DE CONSÓRCIO LTDA.;Prestação inadequada/insuficiente de informação;0;0;2;2;
2018;1º;51597300;PRIMO ROSSI ADMINISTRADORA DE CONSÓRCIO LTDA.;Publicidade enganosa;0;0;1;1;
2018;1º;51597300;PRIMO ROSSI ADMINISTRADORA DE CONSÓRCIO LTDA.;Reclamações relacionadas a assuntos diversos;0;0;5;5;
2018;1º;51597300;PRIMO ROSSI ADMINISTRADORA DE CONSÓRCIO LTDA.;Recusa ou demora no fornecimento de documentos (exceto demonstrativos obrigatórios);0;0;1;1;
2018;1º;91108027;RANDON ADMINISTRADORA DE CONSÓRCIOS LTDA.;Descumprimento de cláusulas referentes à devolução de valores;0;3;0;3;
2018;1º;91108027;RANDON ADMINISTRADORA DE CONSÓRCIOS LTDA.;Descumprimento de obrigações previstas em contratos;0;1;0;1;
2018;1º;91108027;RANDON ADMINISTRADORA DE CONSÓRCIOS LTDA.;Descumprimento de prazo de resposta a demanda;0;1;0;1;
2018;1º;91108027;RANDON ADMINISTRADORA DE CONSÓRCIOS LTDA.;Dificuldade na liberação ou substituição de bem;0;0;1;1;
2018;1º;91108027;RANDON ADMINISTRADORA DE CONSÓRCIOS LTDA.;Irregularidades relacionadas à liberação do crédito;0;2;0;2;
2018;1º;91108027;RANDON ADMINISTRADORA DE CONSÓRCIOS LTDA.;Reclamações relacionadas a assuntos diversos;0;0;1;1;
2018;1º;66228966;REALIZA ADMINISTRADORA DE CONSÓRCIOS LTDA.;Ausência de transparência nas relações contratuais;0;0;2;2;
2018;1º;66228966;REALIZA ADMINISTRADORA DE CONSÓRCIOS LTDA.;Descumprimento de cláusulas referentes à devolução de valores;0;3;0;3;
2018;1º;66228966;REALIZA ADMINISTRADORA DE CONSÓRCIOS LTDA.;Dificuldade na liberação ou substituição de bem;0;0;1;1;
2018;1º;66228966;REALIZA ADMINISTRADORA DE CONSÓRCIOS LTDA.;Insatisfação com a resposta fornecida pela administradora de consórcio relativa à demanda registrada contra ela;0;4;0;4;
2018;1º;66228966;REALIZA ADMINISTRADORA DE CONSÓRCIOS LTDA.;Insatisfação por parte do cliente com o atendimento prestado pela administradora de consórcio;0;0;3;3;
2018;1º;66228966;REALIZA ADMINISTRADORA DE CONSÓRCIOS LTDA.;Irregularidades relacionadas à liberação do crédito;0;2;0;2;
2018;1º;66228966;REALIZA ADMINISTRADORA DE CONSÓRCIOS LTDA.;Irregularidades relacionadas às condições para contemplação por lance ou sorteio;0;3;0;3;
2018;1º;66228966;REALIZA ADMINISTRADORA DE CONSÓRCIOS LTDA.;Outras irregularidades;0;17;0;17;
2018;1º;66228966;REALIZA ADMINISTRADORA DE CONSÓRCIOS LTDA.;Prestação inadequada/insuficiente de informação;0;0;1;1;
2018;1º;66228966;REALIZA ADMINISTRADORA DE CONSÓRCIOS LTDA.;Publicidade enganosa;0;0;11;11;
2018;1º;66228966;REALIZA ADMINISTRADORA DE CONSÓRCIOS LTDA.;Reclamações relacionadas a assuntos diversos;0;0;3;3;
2018;1º;23767155;RECON ADMINISTRADORA DE CONSORCIOS LTDA;Descumprimento de cláusulas referentes à devolução de valores;0;1;0;1;
2018;1º;23767155;RECON ADMINISTRADORA DE CONSORCIOS LTDA;Descumprimento de obrigações previstas em contratos;1;2;0;3;
2018;1º;23767155;RECON ADMINISTRADORA DE CONSORCIOS LTDA;Insatisfação por parte do cliente com o atendimento prestado pela administradora de consórcio;0;0;1;1;
2018;1º;23767155;RECON ADMINISTRADORA DE CONSORCIOS LTDA;Irregularidades relacionadas à liberação do crédito;0;1;0;1;
2018;1º;23767155;RECON ADMINISTRADORA DE CONSORCIOS LTDA;Prestação inadequada/insuficiente de informação;0;0;4;4;
2018;1º;23767155;RECON ADMINISTRADORA DE CONSORCIOS LTDA;Publicidade enganosa;0;0;2;2;
2018;1º;23767155;RECON ADMINISTRADORA DE CONSORCIOS LTDA;Reclamações relacionadas a assuntos diversos;0;0;2;2;
2018;1º;92002609;REDE OESTE ADMINISTRADORA DE CONSORCIOS LTDA.;Descumprimento de prazo de resposta a demanda;0;1;0;1;
2018;1º;92002609;REDE OESTE ADMINISTRADORA DE CONSORCIOS LTDA.;Insatisfação com a resposta fornecida pela administradora de consórcio relativa à demanda registrada contra ela;0;1;0;1;
2018;1º;92002609;REDE OESTE ADMINISTRADORA DE CONSORCIOS LTDA.;Outras irregularidades;0;1;0;1;
2018;1º;62354055;REMAZA ADMINISTRADORA DE CONSÓRCIO LTDA.;Descumprimento de cláusulas referentes à devolução de valores;2;8;0;10;
2018;1º;62354055;REMAZA ADMINISTRADORA DE CONSÓRCIO LTDA.;Descumprimento de obrigações previstas em contratos;1;1;0;2;
2018;1º;62354055;REMAZA ADMINISTRADORA DE CONSÓRCIO LTDA.;Insatisfação com a resposta fornecida pela administradora de consórcio relativa à demanda registrada contra ela;0;1;0;1;
2018;1º;62354055;REMAZA ADMINISTRADORA DE CONSÓRCIO LTDA.;Insatisfação por parte do cliente com o atendimento prestado pela administradora de consórcio;0;0;2;2;
2018;1º;62354055;REMAZA ADMINISTRADORA DE CONSÓRCIO LTDA.;Irregularidades relacionadas à liberação do crédito;1;2;0;3;
2018;1º;62354055;REMAZA ADMINISTRADORA DE CONSÓRCIO LTDA.;Outras irregularidades;1;0;0;1;
2018;1º;62354055;REMAZA ADMINISTRADORA DE CONSÓRCIO LTDA.;Prestação inadequada/insuficiente de informação;0;0;8;8;
2018;1º;62354055;REMAZA ADMINISTRADORA DE CONSÓRCIO LTDA.;Publicidade enganosa;0;0;12;12;
2018;1º;62354055;REMAZA ADMINISTRADORA DE CONSÓRCIO LTDA.;Reclamações relacionadas a assuntos diversos;0;0;2;2;
2018;1º;62354055;REMAZA ADMINISTRADORA DE CONSÓRCIO LTDA.;Recusa ou demora no fornecimento de documentos (exceto demonstrativos obrigatórios);0;0;1;1;
2018;1º;51855716;RODOBENS ADMINISTRADORA DE CONSÓRCIOS LTDA.;Ausência de transparência nas relações contratuais;0;0;6;6;
2018;1º;51855716;RODOBENS ADMINISTRADORA DE CONSÓRCIOS LTDA.;Cobrança irregular de tarifa pela emissão de boletos, carnês e assemelhados;0;1;0;1;
2018;1º;51855716;RODOBENS ADMINISTRADORA DE CONSÓRCIOS LTDA.;Descumprimento de cláusulas referentes à devolução de valores;0;11;0;11;
2018;1º;51855716;RODOBENS ADMINISTRADORA DE CONSÓRCIOS LTDA.;Descumprimento de obrigações previstas em contratos;0;3;0;3;
2018;1º;51855716;RODOBENS ADMINISTRADORA DE CONSÓRCIOS LTDA.;Dificuldade na liberação ou substituição de bem;0;0;3;3;
2018;1º;51855716;RODOBENS ADMINISTRADORA DE CONSÓRCIOS LTDA.;Insatisfação com a resposta fornecida pela administradora de consórcio relativa à demanda registrada contra ela;1;4;0;5;
2018;1º;51855716;RODOBENS ADMINISTRADORA DE CONSÓRCIOS LTDA.;Insatisfação por parte do cliente com o atendimento prestado pela administradora de consórcio;0;0;20;20;
2018;1º;51855716;RODOBENS ADMINISTRADORA DE CONSÓRCIOS LTDA.;Irregularidades relacionadas à liberação do crédito;0;6;0;6;
2018;1º;51855716;RODOBENS ADMINISTRADORA DE CONSÓRCIOS LTDA.;Irregularidades relacionadas às condições para contemplação por lance ou sorteio;0;2;0;2;
2018;1º;51855716;RODOBENS ADMINISTRADORA DE CONSÓRCIOS LTDA.;Outras irregularidades;0;1;0;1;
2018;1º;51855716;RODOBENS ADMINISTRADORA DE CONSÓRCIOS LTDA.;Prestação inadequada/insuficiente de informação;0;0;3;3;
2018;1º;51855716;RODOBENS ADMINISTRADORA DE CONSÓRCIOS LTDA.;Reclamações relacionadas a assuntos diversos;0;0;9;9;
2018;1º;51855716;RODOBENS ADMINISTRADORA DE CONSÓRCIOS LTDA.;Recusa ou demora no fornecimento de documentos (exceto demonstrativos obrigatórios);0;0;7;7;
2018;1º;46206611;SANMELL - ADMINISTRADORA DE CONSORCIOS LTDA;Irregularidades relacionadas às condições para contemplação por lance ou sorteio;1;0;0;1;
2018;1º;55942312;SANTANDER BRASIL ADMINISTRADORA DE CONSÓRCIO LTDA.;Ausência de transparência nas relações contratuais;0;0;2;2;
2018;1º;55942312;SANTANDER BRASIL ADMINISTRADORA DE CONSÓRCIO LTDA.;Descumprimento de cláusulas referentes à devolução de valores;0;12;0;12;
2018;1º;55942312;SANTANDER BRASIL ADMINISTRADORA DE CONSÓRCIO LTDA.;Descumprimento de obrigações previstas em contratos;0;3;0;3;
2018;1º;55942312;SANTANDER BRASIL ADMINISTRADORA DE CONSÓRCIO LTDA.;Descumprimento de prazo de resposta a demanda;0;1;0;1;
2018;1º;55942312;SANTANDER BRASIL ADMINISTRADORA DE CONSÓRCIO LTDA.;Dificuldade na liberação ou substituição de bem;0;0;2;2;
2018;1º;55942312;SANTANDER BRASIL ADMINISTRADORA DE CONSÓRCIO LTDA.;Insatisfação com a resposta fornecida pela administradora de consórcio relativa à demanda registrada contra ela;0;3;0;3;
2018;1º;55942312;SANTANDER BRASIL ADMINISTRADORA DE CONSÓRCIO LTDA.;Insatisfação por parte do cliente com o atendimento prestado pela administradora de consórcio;0;0;9;9;
2018;1º;55942312;SANTANDER BRASIL ADMINISTRADORA DE CONSÓRCIO LTDA.;Irregularidades relacionadas à liberação do crédito;1;22;0;23;
2018;1º;55942312;SANTANDER BRASIL ADMINISTRADORA DE CONSÓRCIO LTDA.;Outras irregularidades;0;1;0;1;
2018;1º;55942312;SANTANDER BRASIL ADMINISTRADORA DE CONSÓRCIO LTDA.;Prestação inadequada/insuficiente de informação;0;0;7;7;
2018;1º;55942312;SANTANDER BRASIL ADMINISTRADORA DE CONSÓRCIO LTDA.;Reclamações relacionadas a assuntos diversos;0;0;9;9;
2018;1º;55942312;SANTANDER BRASIL ADMINISTRADORA DE CONSÓRCIO LTDA.;Recusa ou demora no fornecimento de documentos (exceto demonstrativos obrigatórios);0;0;3;3;
2018;1º;96479258;SCANIA ADMINISTRADORA DE CONSÓRCIOS LTDA.;Ausência de transparência nas relações contratuais;0;0;1;1;
2018;1º;96479258;SCANIA ADMINISTRADORA DE CONSÓRCIOS LTDA.;Irregularidades relacionadas à liberação do crédito;0;2;0;2;
2018;1º;96479258;SCANIA ADMINISTRADORA DE CONSÓRCIOS LTDA.;Prestação inadequada/insuficiente de informação;0;0;1;1;
2018;1º;76515071;SERVOPA ADMINISTRADORA DE CONSORCIOS LTDA;Descumprimento de cláusulas referentes à devolução de valores;0;1;0;1;
2018;1º;76515071;SERVOPA ADMINISTRADORA DE CONSORCIOS LTDA;Descumprimento de obrigações previstas em contratos;0;1;0;1;
2018;1º;76515071;SERVOPA ADMINISTRADORA DE CONSORCIOS LTDA;Insatisfação por parte do cliente com o atendimento prestado pela administradora de consórcio;0;0;1;1;
2018;1º;76515071;SERVOPA ADMINISTRADORA DE CONSORCIOS LTDA;Irregularidades relacionadas às condições para contemplação por lance ou sorteio;0;2;0;2;
2018;1º;76515071;SERVOPA ADMINISTRADORA DE CONSORCIOS LTDA;Reclamações relacionadas a assuntos diversos;0;0;1;1;
2018;1º;87852273;SINOSSERRA ADMINISTRADORA DE CONSÓRCIOS S/A.;Dificuldade na liberação ou substituição de bem;0;0;1;1;
2018;1º;87636643;SOCIEDADE ADMINISTRADORA DE CONSÓRCIOS LTDA.;Insatisfação com a resposta fornecida pela administradora de consórcio relativa à demanda registrada contra ela;1;0;0;1;
2018;1º;87636643;SOCIEDADE ADMINISTRADORA DE CONSÓRCIOS LTDA.;Prestação inadequada/insuficiente de informação;0;0;1;1;
2018;1º;54708839;SPERTA ADMINISTRADORA DE CONSORCIO NACIONAL LTDA;Irregularidades relacionadas à liberação do crédito;0;1;0;1;
2018;1º;87636635;SPONCHIADO ADMINISTRADORA DE CONSÓRCIOS LTDA.;Irregularidades relacionadas à liberação do crédito;0;1;0;1;
2018;1º;53211488;TARRAF ADMINISTRADORA DE CONSÓRCIOS LTDA.;Descumprimento de cláusulas referentes à devolução de valores;0;1;0;1;
2018;1º;53211488;TARRAF ADMINISTRADORA DE CONSÓRCIOS LTDA.;Irregularidades relacionadas à liberação do crédito;0;1;0;1;
2018;1º;05551841;TÁGIDE ADMINISTRADORA DE CONSÓRCIOS LTDA.;Prestação inadequada/insuficiente de informação;0;0;1;1;
2018;1º;59956185;TRADIÇÃO ADMINISTRADORA DE CONSÓRCIO LTDA.;Descumprimento de obrigações previstas em contratos;2;0;0;2;
2018;1º;59956185;TRADIÇÃO ADMINISTRADORA DE CONSÓRCIO LTDA.;Outras irregularidades;0;1;0;1;
2018;1º;59956185;TRADIÇÃO ADMINISTRADORA DE CONSÓRCIO LTDA.;Prestação inadequada/insuficiente de informação;0;0;1;1;
2018;1º;83553883;UNIÃO CATARINENSE ADMINISTRADORA DE CONSORCIOS LTDA;Prestação inadequada/insuficiente de informação;0;0;1;1;
2018;1º;60732997;UNIFISA ADMINISTRADORA NACIONAL DE CONSORCIOS LTDA;Descumprimento de cláusulas referentes à devolução de valores;0;3;0;3;
2018;1º;60732997;UNIFISA ADMINISTRADORA NACIONAL DE CONSORCIOS LTDA;Insatisfação com a resposta fornecida pela administradora de consórcio relativa à demanda registrada contra ela;1;0;0;1;
2018;1º;60732997;UNIFISA ADMINISTRADORA NACIONAL DE CONSORCIOS LTDA;Irregularidades relacionadas às condições para contemplação por lance ou sorteio;0;1;0;1;
2018;1º;60732997;UNIFISA ADMINISTRADORA NACIONAL DE CONSORCIOS LTDA;Outras irregularidades;0;1;0;1;
2018;1º;60732997;UNIFISA ADMINISTRADORA NACIONAL DE CONSORCIOS LTDA;Prestação inadequada/insuficiente de informação;0;0;2;2;
2018;1º;60732997;UNIFISA ADMINISTRADORA NACIONAL DE CONSORCIOS LTDA;Publicidade enganosa;0;0;2;2;
2018;1º;60732997;UNIFISA ADMINISTRADORA NACIONAL DE CONSORCIOS LTDA;Reclamações relacionadas a assuntos diversos;0;0;2;2;
2018;1º;81269516;UNILANCE ADMINISTRADORA DE CONSÓRCIOS LTDA.;Ausência de transparência nas relações contratuais;0;0;1;1;
2018;1º;81269516;UNILANCE ADMINISTRADORA DE CONSÓRCIOS LTDA.;Descumprimento de obrigações previstas em contratos;0;1;0;1;
2018;1º;81269516;UNILANCE ADMINISTRADORA DE CONSÓRCIOS LTDA.;Descumprimento de prazo de resposta a demanda;0;1;0;1;
2018;1º;81269516;UNILANCE ADMINISTRADORA DE CONSÓRCIOS LTDA.;Insatisfação com a resposta fornecida pela administradora de consórcio relativa à demanda registrada contra ela;0;1;0;1;
2018;1º;81269516;UNILANCE ADMINISTRADORA DE CONSÓRCIOS LTDA.;Insatisfação por parte do cliente com o atendimento prestado pela administradora de consórcio;0;0;2;2;
2018;1º;81269516;UNILANCE ADMINISTRADORA DE CONSÓRCIOS LTDA.;Irregularidades relacionadas à liberação do crédito;0;3;0;3;
2018;1º;81269516;UNILANCE ADMINISTRADORA DE CONSÓRCIOS LTDA.;Irregularidades relacionadas às condições para contemplação por lance ou sorteio;0;6;0;6;
2018;1º;81269516;UNILANCE ADMINISTRADORA DE CONSÓRCIOS LTDA.;Outras irregularidades;0;3;0;3;
2018;1º;81269516;UNILANCE ADMINISTRADORA DE CONSÓRCIOS LTDA.;Prestação inadequada/insuficiente de informação;0;0;2;2;
2018;1º;81269516;UNILANCE ADMINISTRADORA DE CONSÓRCIOS LTDA.;Publicidade enganosa;0;0;5;5;
2018;1º;81269516;UNILANCE ADMINISTRADORA DE CONSÓRCIOS LTDA.;Reclamações relacionadas a assuntos diversos;0;0;1;1;
2018;1º;74118381;VOLVO ADMINISTRADORA DE CONSÓRCIO LTDA.;Irregularidades relacionadas à liberação do crédito;1;0;0;1;
2018;1º;74118381;VOLVO ADMINISTRADORA DE CONSÓRCIO LTDA.;Prestação inadequada/insuficiente de informação;0;0;1;1;
2018;1º;74118381;VOLVO ADMINISTRADORA DE CONSÓRCIO LTDA.;Reclamações relacionadas a assuntos diversos;0;0;1;1;
2018;1º;47458153;YAMAHA ADMINISTRADORA DE CONSÓRCIO LTDA.;Ausência de transparência nas relações contratuais;0;0;1;1;
2018;1º;47458153;YAMAHA ADMINISTRADORA DE CONSÓRCIO LTDA.;Descumprimento de cláusulas referentes à devolução de valores;0;4;0;4;
2018;1º;47458153;YAMAHA ADMINISTRADORA DE CONSÓRCIO LTDA.;Insatisfação com a resposta fornecida pela administradora de consórcio relativa à demanda registrada contra ela;0;1;0;1;
2018;1º;47458153;YAMAHA ADMINISTRADORA DE CONSÓRCIO LTDA.;Insatisfação por parte do cliente com o atendimento prestado pela administradora de consórcio;0;0;1;1;
2018;1º;47458153;YAMAHA ADMINISTRADORA DE CONSÓRCIO LTDA.;Irregularidades relacionadas à liberação do crédito;1;4;0;5;
2018;1º;47458153;YAMAHA ADMINISTRADORA DE CONSÓRCIO LTDA.;Prestação inadequada/insuficiente de informação;0;0;1;1;
2018;1º;47458153;YAMAHA ADMINISTRADORA DE CONSÓRCIO LTDA.;Reclamações relacionadas a assuntos diversos;0;0;4;4;
2018;1º;23367634;ZEMA ADMINISTRADORA DE CONSÓRCIO LTDA;Descumprimento de cláusulas referentes à devolução de valores;0;2;0;2;
2018;1º;23367634;ZEMA ADMINISTRADORA DE CONSÓRCIO LTDA;Descumprimento de prazo de resposta a demanda;0;2;0;2;
2018;1º;23367634;ZEMA ADMINISTRADORA DE CONSÓRCIO LTDA;Dificuldade na liberação ou substituição de bem;0;0;1;1;
2018;1º;23367634;ZEMA ADMINISTRADORA DE CONSÓRCIO LTDA;Insatisfação com a resposta fornecida pela administradora de consórcio relativa à demanda registrada contra ela;0;2;0;2;
2018;1º;23367634;ZEMA ADMINISTRADORA DE CONSÓRCIO LTDA;Insatisfação por parte do cliente com o atendimento prestado pela administradora de consórcio;0;0;1;1;
2018;1º;23367634;ZEMA ADMINISTRADORA DE CONSÓRCIO LTDA;Irregularidades relacionadas às condições para contemplação por lance ou sorteio;0;1;0;1;
2018;1º;23367634;ZEMA ADMINISTRADORA DE CONSÓRCIO LTDA;Outras irregularidades;1;0;0;1;
2018;1º;23367634;ZEMA ADMINISTRADORA DE CONSÓRCIO LTDA;Prestação inadequada/insuficiente de informação;0;0;5;5;
2018;1º;23367634;ZEMA ADMINISTRADORA DE CONSÓRCIO LTDA;Publicidade enganosa;0;0;6;6;
2018;1º;23367634;ZEMA ADMINISTRADORA DE CONSÓRCIO LTDA;Recusa ou demora no fornecimento de documentos (exceto demonstrativos obrigatórios);0;0;3;3;
