Ano;Semestre;CNPJ AC;Administradora de consórcio;Irregularidade;Quantidade de reclamações reguladas procedentes;Quantidade de reclamações reguladas - outras;Quantidade de reclamações não reguladas;Quantidade total de reclamações;
2023;2º;84911098;ADEMICON ADMINISTRADORA DE CONSÓRCIOS S.A.;Descumprimento de cláusulas referentes à devolução de valores;0;1;0;1;
2023;2º;84911098;ADEMICON ADMINISTRADORA DE CONSÓRCIOS S.A.;Descumprimento de prazo de resposta a demanda;0;1;0;1;
2023;2º;84911098;ADEMICON ADMINISTRADORA DE CONSÓRCIOS S.A.;Insatisfação por parte do cliente com o atendimento prestado pela administradora de consórcio;0;0;1;1;
2023;2º;84911098;ADEMICON ADMINISTRADORA DE CONSÓRCIOS S.A.;Irregularidades relacionadas à liberação do crédito;0;2;0;2;
2023;2º;84911098;ADEMICON ADMINISTRADORA DE CONSÓRCIOS S.A.;Irregularidades relacionadas às condições para contemplação por lance ou sorteio;0;1;0;1;
2023;2º;84911098;ADEMICON ADMINISTRADORA DE CONSÓRCIOS S.A.;Irregularidades relativas a integridade, confiabilidade, segurança, sigilo ou legitimidade das operações e serviços prestados relacionados a administradora de consórcio;2;2;0;4;
2023;2º;84911098;ADEMICON ADMINISTRADORA DE CONSÓRCIOS S.A.;Não fornecimento, remessa ou divulgação de documentos por parte de administradora de consórcio;1;0;0;1;
2023;2º;84911098;ADEMICON ADMINISTRADORA DE CONSÓRCIOS S.A.;Oferta ou prestação de informação a respeito de produtos e serviços de forma inadequada por administradora de consórcio;1;0;0;1;
2023;2º;06044551;ADMINISTRADORA DE CONSORCIO NACIONAL GAZIN LTDA;Cobranças Diversas - Consórcio;0;0;1;1;
2023;2º;06044551;ADMINISTRADORA DE CONSORCIO NACIONAL GAZIN LTDA;Insatisfação por parte do cliente com o atendimento prestado pela administradora de consórcio;0;0;1;1;
2023;2º;06044551;ADMINISTRADORA DE CONSORCIO NACIONAL GAZIN LTDA;Irregularidades relacionadas à liberação do crédito;1;0;0;1;
2023;2º;06044551;ADMINISTRADORA DE CONSORCIO NACIONAL GAZIN LTDA;Irregularidades relativas a integridade, confiabilidade, segurança, sigilo ou legitimidade das operações e serviços prestados relacionados a administradora de consórcio;1;0;0;1;
2023;2º;45441789;ADMINISTRADORA DE CONSORCIO NACIONAL HONDA LTDA;Cancelamento de contrato a pedido do cliente não atendido por administradora de consórcio;1;0;0;1;
2023;2º;45441789;ADMINISTRADORA DE CONSORCIO NACIONAL HONDA LTDA;Cobranças Diversas - Consórcio;0;0;2;2;
2023;2º;45441789;ADMINISTRADORA DE CONSORCIO NACIONAL HONDA LTDA;Descumprimento de cláusulas referentes à devolução de valores;3;5;0;8;
2023;2º;45441789;ADMINISTRADORA DE CONSORCIO NACIONAL HONDA LTDA;Descumprimento de obrigações previstas em contratos;1;4;0;5;
2023;2º;45441789;ADMINISTRADORA DE CONSORCIO NACIONAL HONDA LTDA;Insatisfação com a resposta fornecida pela administradora de consórcio relativa à demanda registrada contra ela;2;5;0;7;
2023;2º;45441789;ADMINISTRADORA DE CONSORCIO NACIONAL HONDA LTDA;Insatisfação por parte do cliente com o atendimento prestado pela administradora de consórcio;0;0;1;1;
2023;2º;45441789;ADMINISTRADORA DE CONSORCIO NACIONAL HONDA LTDA;Irregularidades relacionadas a informações e liquidação de valores a receber no sistema SVR do BCB por parte de consórcios;30;8;0;38;
2023;2º;45441789;ADMINISTRADORA DE CONSORCIO NACIONAL HONDA LTDA;Irregularidades relacionadas à liberação do crédito;3;8;0;11;
2023;2º;45441789;ADMINISTRADORA DE CONSORCIO NACIONAL HONDA LTDA;Irregularidades relacionadas às condições para contemplação por lance ou sorteio;0;1;0;1;
2023;2º;45441789;ADMINISTRADORA DE CONSORCIO NACIONAL HONDA LTDA;Irregularidades relativas a integridade, confiabilidade, segurança, sigilo ou legitimidade das operações e serviços prestados relacionados a administradora de consórcio;17;6;0;23;
2023;2º;45441789;ADMINISTRADORA DE CONSORCIO NACIONAL HONDA LTDA;Não fornecimento, remessa ou divulgação de documentos por parte de administradora de consórcio;4;0;0;4;
2023;2º;45441789;ADMINISTRADORA DE CONSORCIO NACIONAL HONDA LTDA;Reclamações relacionadas a assuntos diversos;0;0;4;4;
2023;2º;45441789;ADMINISTRADORA DE CONSORCIO NACIONAL HONDA LTDA;Renegociação de dívida - Consórcio;0;0;2;2;
2023;2º;07808907;ADMINISTRADORA DE CONSORCIOS SICREDI LTDA;Irregularidades relativas a integridade, confiabilidade, segurança, sigilo ou legitimidade das operações e serviços prestados relacionados a administradora de consórcio;1;1;0;2;
2023;2º;07808907;ADMINISTRADORA DE CONSORCIOS SICREDI LTDA;Não fornecimento, remessa ou divulgação de documentos por parte de administradora de consórcio;0;1;0;1;
2023;2º;07808907;ADMINISTRADORA DE CONSORCIOS SICREDI LTDA;Oferta ou prestação de informação a respeito de produtos e serviços de forma inadequada por administradora de consórcio;1;0;0;1;
2023;2º;73230674;ADMINISTRADORA DE CONSÓRCIO RCI BRASIL LTDA;Descumprimento de cláusulas referentes à devolução de valores;1;2;0;3;
2023;2º;73230674;ADMINISTRADORA DE CONSÓRCIO RCI BRASIL LTDA;Insatisfação com a resposta fornecida pela administradora de consórcio relativa à demanda registrada contra ela;0;1;0;1;
2023;2º;73230674;ADMINISTRADORA DE CONSÓRCIO RCI BRASIL LTDA;Irregularidades relacionadas à liberação do crédito;1;6;0;7;
2023;2º;73230674;ADMINISTRADORA DE CONSÓRCIO RCI BRASIL LTDA;Irregularidades relativas a integridade, confiabilidade, segurança, sigilo ou legitimidade das operações e serviços prestados relacionados a administradora de consórcio;6;3;0;9;
2023;2º;73230674;ADMINISTRADORA DE CONSÓRCIO RCI BRASIL LTDA;Oferta ou prestação de informação a respeito de produtos e serviços de forma inadequada por administradora de consórcio;0;1;0;1;
2023;2º;91341925;ADMINISTRADORA DE CONSÓRCIO SPENGLER LTDA.;Não fornecimento, remessa ou divulgação de documentos por parte de administradora de consórcio;1;0;0;1;
2023;2º;12228808;ADMINISTRADORA DE CONSÓRCIO UNICOOB LTDA;Descumprimento de obrigações previstas em contratos;0;1;0;1;
2023;2º;12228808;ADMINISTRADORA DE CONSÓRCIO UNICOOB LTDA;Irregularidades relativas a integridade, confiabilidade, segurança, sigilo ou legitimidade das operações e serviços prestados relacionados a administradora de consórcio;1;2;0;3;
2023;2º;12228808;ADMINISTRADORA DE CONSÓRCIO UNICOOB LTDA;Renegociação de dívida - Consórcio;0;0;1;1;
2023;2º;90982679;ALPHA ADMINISTRADORA DE CONSÓRCIO LTDA.;Insatisfação por parte do cliente com o atendimento prestado pela administradora de consórcio;0;0;1;1;
2023;2º;90982679;ALPHA ADMINISTRADORA DE CONSÓRCIO LTDA.;Irregularidades relacionadas à liberação do crédito;0;1;0;1;
2023;2º;90982679;ALPHA ADMINISTRADORA DE CONSÓRCIO LTDA.;Irregularidades relativas a integridade, confiabilidade, segurança, sigilo ou legitimidade das operações e serviços prestados relacionados a administradora de consórcio;2;0;0;2;
2023;2º;90982679;ALPHA ADMINISTRADORA DE CONSÓRCIO LTDA.;Não fornecimento, remessa ou divulgação de documentos por parte de administradora de consórcio;0;1;0;1;
2023;2º;90982679;ALPHA ADMINISTRADORA DE CONSÓRCIO LTDA.;Oferta ou prestação de informação a respeito de produtos e serviços de forma inadequada por administradora de consórcio;3;2;0;5;
2023;2º;60375243;ANCORA ADMINISTRADORA DE CONSORCIOS S.A.;Descumprimento de cláusulas referentes à devolução de valores;0;1;0;1;
2023;2º;60375243;ANCORA ADMINISTRADORA DE CONSORCIOS S.A.;Descumprimento de prazo de resposta a demanda;0;1;0;1;
2023;2º;60375243;ANCORA ADMINISTRADORA DE CONSORCIOS S.A.;Insatisfação com a resposta fornecida pela administradora de consórcio relativa à demanda registrada contra ela;0;2;0;2;
2023;2º;60375243;ANCORA ADMINISTRADORA DE CONSORCIOS S.A.;Irregularidades relacionadas a informações e liquidação de valores a receber no sistema SVR do BCB por parte de consórcios;0;1;0;1;
2023;2º;60375243;ANCORA ADMINISTRADORA DE CONSORCIOS S.A.;Irregularidades relacionadas à liberação do crédito;1;2;0;3;
2023;2º;60375243;ANCORA ADMINISTRADORA DE CONSORCIOS S.A.;Irregularidades relacionadas às condições para contemplação por lance ou sorteio;0;1;0;1;
2023;2º;60375243;ANCORA ADMINISTRADORA DE CONSORCIOS S.A.;Irregularidades relativas a integridade, confiabilidade, segurança, sigilo ou legitimidade das operações e serviços prestados relacionados a administradora de consórcio;4;1;0;5;
2023;2º;60375243;ANCORA ADMINISTRADORA DE CONSORCIOS S.A.;Não fornecimento, remessa ou divulgação de documentos por parte de administradora de consórcio;1;0;0;1;
2023;2º;60375243;ANCORA ADMINISTRADORA DE CONSORCIOS S.A.;Oferta ou prestação de informação a respeito de produtos e serviços de forma inadequada por administradora de consórcio;5;1;0;6;
2023;2º;71045363;BAMAQ ADMINISTRADORA DE CONSÓRCIOS LTDA;Descumprimento de obrigações previstas em contratos;1;2;0;3;
2023;2º;71045363;BAMAQ ADMINISTRADORA DE CONSÓRCIOS LTDA;Irregularidades relacionadas à liberação do crédito;0;1;0;1;
2023;2º;71045363;BAMAQ ADMINISTRADORA DE CONSÓRCIOS LTDA;Irregularidades relacionadas às condições para contemplação por lance ou sorteio;0;1;0;1;
2023;2º;71045363;BAMAQ ADMINISTRADORA DE CONSÓRCIOS LTDA;Irregularidades relativas a integridade, confiabilidade, segurança, sigilo ou legitimidade das operações e serviços prestados relacionados a administradora de consórcio;5;2;0;7;
2023;2º;71045363;BAMAQ ADMINISTRADORA DE CONSÓRCIOS LTDA;Oferta ou prestação de informação a respeito de produtos e serviços de forma inadequada por administradora de consórcio;1;1;0;2;
2023;2º;02010478;BANCORBRÁS ADMINISTRADORA DE CONSÓRCIOS S.A.;Descumprimento de cláusulas referentes à devolução de valores;1;2;0;3;
2023;2º;02010478;BANCORBRÁS ADMINISTRADORA DE CONSÓRCIOS S.A.;Descumprimento de obrigações previstas em contratos;0;2;0;2;
2023;2º;02010478;BANCORBRÁS ADMINISTRADORA DE CONSÓRCIOS S.A.;Insatisfação com a resposta fornecida pela administradora de consórcio relativa à demanda registrada contra ela;0;1;0;1;
2023;2º;02010478;BANCORBRÁS ADMINISTRADORA DE CONSÓRCIOS S.A.;Oferta ou prestação de informação a respeito de produtos e serviços de forma inadequada por administradora de consórcio;1;0;0;1;
2023;2º;92692979;BANRISUL S.A. - ADMINISTRADORA DE CONSÓRCIOS;Descumprimento de cláusulas referentes à devolução de valores;1;2;0;3;
2023;2º;92692979;BANRISUL S.A. - ADMINISTRADORA DE CONSÓRCIOS;Insatisfação com a resposta fornecida pela administradora de consórcio relativa à demanda registrada contra ela;0;1;0;1;
2023;2º;92692979;BANRISUL S.A. - ADMINISTRADORA DE CONSÓRCIOS;Irregularidades relacionadas a informações e liquidação de valores a receber no sistema SVR do BCB por parte de consórcios;0;1;0;1;
2023;2º;92692979;BANRISUL S.A. - ADMINISTRADORA DE CONSÓRCIOS;Irregularidades relacionadas às condições para contemplação por lance ou sorteio;0;1;0;1;
2023;2º;92692979;BANRISUL S.A. - ADMINISTRADORA DE CONSÓRCIOS;Irregularidades relativas a integridade, confiabilidade, segurança, sigilo ou legitimidade das operações e serviços prestados relacionados a administradora de consórcio;1;0;0;1;
2023;2º;06043050;BB ADMINISTRADORA DE CONSORCIOS S.A.;Cancelamento de contrato a pedido do cliente não atendido por administradora de consórcio;5;0;0;5;
2023;2º;06043050;BB ADMINISTRADORA DE CONSORCIOS S.A.;Descumprimento de cláusulas referentes à devolução de valores;8;14;0;22;
2023;2º;06043050;BB ADMINISTRADORA DE CONSORCIOS S.A.;Descumprimento de obrigações previstas em contratos;1;7;0;8;
2023;2º;06043050;BB ADMINISTRADORA DE CONSORCIOS S.A.;Descumprimento de ordem judicial - Consórcio;0;0;1;1;
2023;2º;06043050;BB ADMINISTRADORA DE CONSORCIOS S.A.;Falta de transparência na redação de documentos por parte de administradora de consórcio;1;0;0;1;
2023;2º;06043050;BB ADMINISTRADORA DE CONSORCIOS S.A.;Insatisfação com a resposta fornecida pela administradora de consórcio relativa à demanda registrada contra ela;2;6;0;8;
2023;2º;06043050;BB ADMINISTRADORA DE CONSORCIOS S.A.;Insatisfação por parte do cliente com o atendimento prestado pela administradora de consórcio;0;0;3;3;
2023;2º;06043050;BB ADMINISTRADORA DE CONSORCIOS S.A.;Irregularidades relacionadas a informações e liquidação de valores a receber no sistema SVR do BCB por parte de consórcios;5;0;0;5;
2023;2º;06043050;BB ADMINISTRADORA DE CONSORCIOS S.A.;Irregularidades relacionadas à liberação do crédito;15;20;0;35;
2023;2º;06043050;BB ADMINISTRADORA DE CONSORCIOS S.A.;Irregularidades relacionadas às condições para contemplação por lance ou sorteio;0;1;0;1;
2023;2º;06043050;BB ADMINISTRADORA DE CONSORCIOS S.A.;Irregularidades relativas a integridade, confiabilidade, segurança, sigilo ou legitimidade das operações e serviços prestados relacionados a administradora de consórcio;78;20;0;98;
2023;2º;06043050;BB ADMINISTRADORA DE CONSORCIOS S.A.;Não fornecimento, remessa ou divulgação de documentos por parte de administradora de consórcio;2;5;0;7;
2023;2º;06043050;BB ADMINISTRADORA DE CONSORCIOS S.A.;Oferta ou prestação de informação a respeito de produtos e serviços de forma inadequada por administradora de consórcio;15;6;0;21;
2023;2º;06043050;BB ADMINISTRADORA DE CONSORCIOS S.A.;Recusa de produtos ou serviços - Consórcio;0;0;6;6;
2023;2º;06043050;BB ADMINISTRADORA DE CONSORCIOS S.A.;Renegociação de dívida - Consórcio;0;0;2;2;
2023;2º;14723388;BR CONSÓRCIOS ADMINISTRADORA DE CONSÓRCIOS LTDA;Cancelamento de contrato a pedido do cliente não atendido por administradora de consórcio;1;0;0;1;
2023;2º;14723388;BR CONSÓRCIOS ADMINISTRADORA DE CONSÓRCIOS LTDA;Descumprimento de cláusulas referentes à devolução de valores;0;2;0;2;
2023;2º;14723388;BR CONSÓRCIOS ADMINISTRADORA DE CONSÓRCIOS LTDA;Irregularidades relativas a integridade, confiabilidade, segurança, sigilo ou legitimidade das operações e serviços prestados relacionados a administradora de consórcio;0;1;0;1;
2023;2º;14723388;BR CONSÓRCIOS ADMINISTRADORA DE CONSÓRCIOS LTDA;Não fornecimento, remessa ou divulgação de documentos por parte de administradora de consórcio;0;1;0;1;
2023;2º;14723388;BR CONSÓRCIOS ADMINISTRADORA DE CONSÓRCIOS LTDA;Oferta ou prestação de informação a respeito de produtos e serviços de forma inadequada por administradora de consórcio;2;0;0;2;
2023;2º;14723388;BR CONSÓRCIOS ADMINISTRADORA DE CONSÓRCIOS LTDA;Outras irregularidades;0;1;0;1;
2023;2º;52568821;BRADESCO ADMINISTRADORA DE CONSÓRCIOS LTDA.;Cancelamento de contrato a pedido do cliente não atendido por administradora de consórcio;4;2;0;6;
2023;2º;52568821;BRADESCO ADMINISTRADORA DE CONSÓRCIOS LTDA.;Cobrança irregular de tarifa pela emissão de boletos, carnês e assemelhados;0;2;0;2;
2023;2º;52568821;BRADESCO ADMINISTRADORA DE CONSÓRCIOS LTDA.;Cobranças Diversas - Consórcio;0;0;4;4;
2023;2º;52568821;BRADESCO ADMINISTRADORA DE CONSÓRCIOS LTDA.;Descumprimento de cláusulas referentes à devolução de valores;26;32;0;58;
2023;2º;52568821;BRADESCO ADMINISTRADORA DE CONSÓRCIOS LTDA.;Descumprimento de obrigações previstas em contratos;6;21;0;27;
2023;2º;52568821;BRADESCO ADMINISTRADORA DE CONSÓRCIOS LTDA.;Descumprimento de ordem judicial - Consórcio;0;0;3;3;
2023;2º;52568821;BRADESCO ADMINISTRADORA DE CONSÓRCIOS LTDA.;Descumprimento de prazo de resposta a demanda;2;6;0;8;
2023;2º;52568821;BRADESCO ADMINISTRADORA DE CONSÓRCIOS LTDA.;Falta de transparência na redação de documentos por parte de administradora de consórcio;3;0;0;3;
2023;2º;52568821;BRADESCO ADMINISTRADORA DE CONSÓRCIOS LTDA.;Insatisfação com a resposta fornecida pela administradora de consórcio relativa à demanda registrada contra ela;13;37;0;50;
2023;2º;52568821;BRADESCO ADMINISTRADORA DE CONSÓRCIOS LTDA.;Insatisfação por parte do cliente com o atendimento prestado pela administradora de consórcio;0;0;7;7;
2023;2º;52568821;BRADESCO ADMINISTRADORA DE CONSÓRCIOS LTDA.;Irregularidades relacionadas a informações e liquidação de valores a receber no sistema SVR do BCB por parte de consórcios;10;34;0;44;
2023;2º;52568821;BRADESCO ADMINISTRADORA DE CONSÓRCIOS LTDA.;Irregularidades relacionadas à liberação do crédito;35;77;0;112;
2023;2º;52568821;BRADESCO ADMINISTRADORA DE CONSÓRCIOS LTDA.;Irregularidades relacionadas às condições para contemplação por lance ou sorteio;2;2;0;4;
2023;2º;52568821;BRADESCO ADMINISTRADORA DE CONSÓRCIOS LTDA.;Irregularidades relativas a integridade, confiabilidade, segurança, sigilo ou legitimidade das operações e serviços prestados relacionados a administradora de consórcio;169;66;0;235;
2023;2º;52568821;BRADESCO ADMINISTRADORA DE CONSÓRCIOS LTDA.;Não fornecimento, remessa ou divulgação de documentos por parte de administradora de consórcio;13;10;0;23;
2023;2º;52568821;BRADESCO ADMINISTRADORA DE CONSÓRCIOS LTDA.;Oferta ou prestação de informação a respeito de produtos e serviços de forma inadequada por administradora de consórcio;39;7;0;46;
2023;2º;52568821;BRADESCO ADMINISTRADORA DE CONSÓRCIOS LTDA.;Outras irregularidades;2;1;0;3;
2023;2º;52568821;BRADESCO ADMINISTRADORA DE CONSÓRCIOS LTDA.;Outras irregularidades relacionadas à Ouvidoria;1;0;0;1;
2023;2º;52568821;BRADESCO ADMINISTRADORA DE CONSÓRCIOS LTDA.;Reclamações relacionadas a assuntos diversos;0;0;4;4;
2023;2º;52568821;BRADESCO ADMINISTRADORA DE CONSÓRCIOS LTDA.;Recusa de produtos ou serviços - Consórcio;0;0;5;5;
2023;2º;52568821;BRADESCO ADMINISTRADORA DE CONSÓRCIOS LTDA.;Renegociação de dívida - Consórcio;0;0;14;14;
2023;2º;52568821;BRADESCO ADMINISTRADORA DE CONSÓRCIOS LTDA.;Restrições cadastrais - Consórcio;0;0;2;2;
2023;2º;03762395;BRENNER ADMINISTRADORA DE CONSORCIO LTDA;Irregularidades relativas a integridade, confiabilidade, segurança, sigilo ou legitimidade das operações e serviços prestados relacionados a administradora de consórcio;0;1;0;1;
2023;2º;45713971;BRQUALY ADMINISTRADORA DE CONSÓRCIOS LTDA.;Insatisfação por parte do cliente com o atendimento prestado pela administradora de consórcio;0;0;1;1;
2023;2º;45713971;BRQUALY ADMINISTRADORA DE CONSÓRCIOS LTDA.;Irregularidades relacionadas à liberação do crédito;0;1;0;1;
2023;2º;45713971;BRQUALY ADMINISTRADORA DE CONSÓRCIOS LTDA.;Irregularidades relacionadas às condições para contemplação por lance ou sorteio;0;1;0;1;
2023;2º;45713971;BRQUALY ADMINISTRADORA DE CONSÓRCIOS LTDA.;Não fornecimento, remessa ou divulgação de documentos por parte de administradora de consórcio;1;0;0;1;
2023;2º;68318773;CANOPUS ADMINISTRADORA DE CONSORCIOS S/A;Cobranças Diversas - Consórcio;0;0;1;1;
2023;2º;68318773;CANOPUS ADMINISTRADORA DE CONSORCIOS S/A;Descumprimento de cláusulas referentes à devolução de valores;0;1;0;1;
2023;2º;68318773;CANOPUS ADMINISTRADORA DE CONSORCIOS S/A;Irregularidades relacionadas à liberação do crédito;0;1;0;1;
2023;2º;68318773;CANOPUS ADMINISTRADORA DE CONSORCIOS S/A;Irregularidades relativas a integridade, confiabilidade, segurança, sigilo ou legitimidade das operações e serviços prestados relacionados a administradora de consórcio;0;2;0;2;
2023;2º;68318773;CANOPUS ADMINISTRADORA DE CONSORCIOS S/A;Não fornecimento, remessa ou divulgação de documentos por parte de administradora de consórcio;0;1;0;1;
2023;2º;68318773;CANOPUS ADMINISTRADORA DE CONSORCIOS S/A;Oferta ou prestação de informação a respeito de produtos e serviços de forma inadequada por administradora de consórcio;1;3;0;4;
2023;2º;68318773;CANOPUS ADMINISTRADORA DE CONSORCIOS S/A;Renegociação de dívida - Consórcio;0;0;1;1;
2023;2º;00266031;CICAL ADMINISTRADORA DE CONSÓRCIOS LTDA;Irregularidades relativas a integridade, confiabilidade, segurança, sigilo ou legitimidade das operações e serviços prestados relacionados a administradora de consórcio;1;0;0;1;
2023;2º;59129403;CNF - ADMINISTRADORA DE CONSÓRCIOS NACIONAL LTDA.;Descumprimento de cláusulas referentes à devolução de valores;0;1;0;1;
2023;2º;59129403;CNF - ADMINISTRADORA DE CONSÓRCIOS NACIONAL LTDA.;Irregularidades relativas a integridade, confiabilidade, segurança, sigilo ou legitimidade das operações e serviços prestados relacionados a administradora de consórcio;1;2;0;3;
2023;2º;62798475;CNK ADMINISTRADORA DE CONSÓRCIO LTDA.;Insatisfação com a resposta fornecida pela administradora de consórcio relativa à demanda registrada contra ela;0;1;0;1;
2023;2º;62798475;CNK ADMINISTRADORA DE CONSÓRCIO LTDA.;Insatisfação por parte do cliente com o atendimento prestado pela administradora de consórcio;0;0;1;1;
2023;2º;62798475;CNK ADMINISTRADORA DE CONSÓRCIO LTDA.;Irregularidades relativas a integridade, confiabilidade, segurança, sigilo ou legitimidade das operações e serviços prestados relacionados a administradora de consórcio;0;2;0;2;
2023;2º;62798475;CNK ADMINISTRADORA DE CONSÓRCIO LTDA.;Oferta ou prestação de informação a respeito de produtos e serviços de forma inadequada por administradora de consórcio;6;4;0;10;
2023;2º;62798475;CNK ADMINISTRADORA DE CONSÓRCIO LTDA.;Reclamações relacionadas a assuntos diversos;0;0;2;2;
2023;2º;05349595;CNP CONSÓRCIO S.A. ADMINISTRADORA DE CONSÓRCIOS;Cancelamento de contrato a pedido do cliente não atendido por administradora de consórcio;1;1;0;2;
2023;2º;05349595;CNP CONSÓRCIO S.A. ADMINISTRADORA DE CONSÓRCIOS;Cobrança irregular de tarifa pela emissão de boletos, carnês e assemelhados;0;1;0;1;
2023;2º;05349595;CNP CONSÓRCIO S.A. ADMINISTRADORA DE CONSÓRCIOS;Cobranças Diversas - Consórcio;0;0;2;2;
2023;2º;05349595;CNP CONSÓRCIO S.A. ADMINISTRADORA DE CONSÓRCIOS;Descumprimento de cláusulas referentes à devolução de valores;6;7;0;13;
2023;2º;05349595;CNP CONSÓRCIO S.A. ADMINISTRADORA DE CONSÓRCIOS;Descumprimento de obrigações previstas em contratos;0;6;0;6;
2023;2º;05349595;CNP CONSÓRCIO S.A. ADMINISTRADORA DE CONSÓRCIOS;Descumprimento de prazo de resposta a demanda;0;1;0;1;
2023;2º;05349595;CNP CONSÓRCIO S.A. ADMINISTRADORA DE CONSÓRCIOS;Insatisfação com a resposta fornecida pela administradora de consórcio relativa à demanda registrada contra ela;4;9;0;13;
2023;2º;05349595;CNP CONSÓRCIO S.A. ADMINISTRADORA DE CONSÓRCIOS;Insatisfação por parte do cliente com o atendimento prestado pela administradora de consórcio;0;0;1;1;
2023;2º;05349595;CNP CONSÓRCIO S.A. ADMINISTRADORA DE CONSÓRCIOS;Irregularidades relacionadas a informações e liquidação de valores a receber no sistema SVR do BCB por parte de consórcios;6;2;0;8;
2023;2º;05349595;CNP CONSÓRCIO S.A. ADMINISTRADORA DE CONSÓRCIOS;Irregularidades relacionadas à liberação do crédito;9;25;0;34;
2023;2º;05349595;CNP CONSÓRCIO S.A. ADMINISTRADORA DE CONSÓRCIOS;Irregularidades relacionadas às condições para contemplação por lance ou sorteio;0;1;0;1;
2023;2º;05349595;CNP CONSÓRCIO S.A. ADMINISTRADORA DE CONSÓRCIOS;Irregularidades relativas a integridade, confiabilidade, segurança, sigilo ou legitimidade das operações e serviços prestados relacionados a administradora de consórcio;47;19;0;66;
2023;2º;05349595;CNP CONSÓRCIO S.A. ADMINISTRADORA DE CONSÓRCIOS;Não fornecimento, remessa ou divulgação de documentos por parte de administradora de consórcio;3;5;0;8;
2023;2º;05349595;CNP CONSÓRCIO S.A. ADMINISTRADORA DE CONSÓRCIOS;Oferta ou prestação de informação a respeito de produtos e serviços de forma inadequada por administradora de consórcio;14;0;0;14;
2023;2º;05349595;CNP CONSÓRCIO S.A. ADMINISTRADORA DE CONSÓRCIOS;Outras irregularidades relacionadas à Ouvidoria;1;0;0;1;
2023;2º;05349595;CNP CONSÓRCIO S.A. ADMINISTRADORA DE CONSÓRCIOS;Reclamações relacionadas a assuntos diversos;0;0;2;2;
2023;2º;05349595;CNP CONSÓRCIO S.A. ADMINISTRADORA DE CONSÓRCIOS;Recusa de produtos ou serviços - Consórcio;0;0;1;1;
2023;2º;05349595;CNP CONSÓRCIO S.A. ADMINISTRADORA DE CONSÓRCIOS;Renegociação de dívida - Consórcio;0;0;3;3;
2023;2º;27268770;COIMEX ADMINISTRADORA DE CONSÓRCIOS S.A.;Descumprimento de cláusulas referentes à devolução de valores;0;1;0;1;
2023;2º;27268770;COIMEX ADMINISTRADORA DE CONSÓRCIOS S.A.;Descumprimento de obrigações previstas em contratos;0;2;0;2;
2023;2º;27268770;COIMEX ADMINISTRADORA DE CONSÓRCIOS S.A.;Falta de transparência na redação de documentos por parte de administradora de consórcio;1;0;0;1;
2023;2º;27268770;COIMEX ADMINISTRADORA DE CONSÓRCIOS S.A.;Irregularidades relacionadas a informações e liquidação de valores a receber no sistema SVR do BCB por parte de consórcios;1;0;0;1;
2023;2º;27268770;COIMEX ADMINISTRADORA DE CONSÓRCIOS S.A.;Irregularidades relacionadas à liberação do crédito;1;5;0;6;
2023;2º;27268770;COIMEX ADMINISTRADORA DE CONSÓRCIOS S.A.;Irregularidades relativas a integridade, confiabilidade, segurança, sigilo ou legitimidade das operações e serviços prestados relacionados a administradora de consórcio;0;1;0;1;
2023;2º;27268770;COIMEX ADMINISTRADORA DE CONSÓRCIOS S.A.;Oferta ou prestação de informação a respeito de produtos e serviços de forma inadequada por administradora de consórcio;0;2;0;2;
2023;2º;07336852;CONBRAV - ADMINISTRADORA DE CONSÓRCIOS LTDA.;Irregularidades relacionadas às condições para contemplação por lance ou sorteio;0;1;0;1;
2023;2º;44196293;CONSHOP ADMINISTRADORA DE CONSORCIOS LTDA.;Descumprimento de cláusulas referentes à devolução de valores;1;0;0;1;
2023;2º;44196293;CONSHOP ADMINISTRADORA DE CONSORCIOS LTDA.;Descumprimento de obrigações previstas em contratos;0;1;0;1;
2023;2º;44196293;CONSHOP ADMINISTRADORA DE CONSORCIOS LTDA.;Descumprimento de prazo de resposta a demanda;2;0;0;2;
2023;2º;44196293;CONSHOP ADMINISTRADORA DE CONSORCIOS LTDA.;Insatisfação com a resposta fornecida pela administradora de consórcio relativa à demanda registrada contra ela;0;1;0;1;
2023;2º;44196293;CONSHOP ADMINISTRADORA DE CONSORCIOS LTDA.;Irregularidades relacionadas à liberação do crédito;0;1;0;1;
2023;2º;44196293;CONSHOP ADMINISTRADORA DE CONSORCIOS LTDA.;Irregularidades relativas a integridade, confiabilidade, segurança, sigilo ou legitimidade das operações e serviços prestados relacionados a administradora de consórcio;1;1;0;2;
2023;2º;44196293;CONSHOP ADMINISTRADORA DE CONSORCIOS LTDA.;Oferta ou prestação de informação a respeito de produtos e serviços de forma inadequada por administradora de consórcio;1;0;0;1;
2023;2º;44196293;CONSHOP ADMINISTRADORA DE CONSORCIOS LTDA.;Outras irregularidades;0;1;0;1;
2023;2º;47658539;CONSÓRCIO NACIONAL VOLKSWAGEN - ADMINISTRADORA DE CONSÓRCIO LTDA.;Cancelamento de contrato a pedido do cliente não atendido por administradora de consórcio;1;1;0;2;
2023;2º;47658539;CONSÓRCIO NACIONAL VOLKSWAGEN - ADMINISTRADORA DE CONSÓRCIO LTDA.;Cobranças Diversas - Consórcio;0;0;2;2;
2023;2º;47658539;CONSÓRCIO NACIONAL VOLKSWAGEN - ADMINISTRADORA DE CONSÓRCIO LTDA.;Descumprimento de cláusulas referentes à devolução de valores;13;36;0;49;
2023;2º;47658539;CONSÓRCIO NACIONAL VOLKSWAGEN - ADMINISTRADORA DE CONSÓRCIO LTDA.;Descumprimento de obrigações previstas em contratos;0;6;0;6;
2023;2º;47658539;CONSÓRCIO NACIONAL VOLKSWAGEN - ADMINISTRADORA DE CONSÓRCIO LTDA.;Descumprimento de ordem judicial - Consórcio;0;0;3;3;
2023;2º;47658539;CONSÓRCIO NACIONAL VOLKSWAGEN - ADMINISTRADORA DE CONSÓRCIO LTDA.;Descumprimento de prazo de resposta a demanda;0;2;0;2;
2023;2º;47658539;CONSÓRCIO NACIONAL VOLKSWAGEN - ADMINISTRADORA DE CONSÓRCIO LTDA.;Falta de transparência na redação de documentos por parte de administradora de consórcio;1;0;0;1;
2023;2º;47658539;CONSÓRCIO NACIONAL VOLKSWAGEN - ADMINISTRADORA DE CONSÓRCIO LTDA.;Insatisfação com a resposta fornecida pela administradora de consórcio relativa à demanda registrada contra ela;1;8;0;9;
2023;2º;47658539;CONSÓRCIO NACIONAL VOLKSWAGEN - ADMINISTRADORA DE CONSÓRCIO LTDA.;Insatisfação por parte do cliente com o atendimento prestado pela administradora de consórcio;0;0;14;14;
2023;2º;47658539;CONSÓRCIO NACIONAL VOLKSWAGEN - ADMINISTRADORA DE CONSÓRCIO LTDA.;Irregularidades relacionadas a informações e liquidação de valores a receber no sistema SVR do BCB por parte de consórcios;3;9;0;12;
2023;2º;47658539;CONSÓRCIO NACIONAL VOLKSWAGEN - ADMINISTRADORA DE CONSÓRCIO LTDA.;Irregularidades relacionadas à liberação do crédito;10;23;0;33;
2023;2º;47658539;CONSÓRCIO NACIONAL VOLKSWAGEN - ADMINISTRADORA DE CONSÓRCIO LTDA.;Irregularidades relacionadas às condições para contemplação por lance ou sorteio;0;1;0;1;
2023;2º;47658539;CONSÓRCIO NACIONAL VOLKSWAGEN - ADMINISTRADORA DE CONSÓRCIO LTDA.;Irregularidades relativas a integridade, confiabilidade, segurança, sigilo ou legitimidade das operações e serviços prestados relacionados a administradora de consórcio;34;22;0;56;
2023;2º;47658539;CONSÓRCIO NACIONAL VOLKSWAGEN - ADMINISTRADORA DE CONSÓRCIO LTDA.;Não fornecimento, remessa ou divulgação de documentos por parte de administradora de consórcio;7;9;0;16;
2023;2º;47658539;CONSÓRCIO NACIONAL VOLKSWAGEN - ADMINISTRADORA DE CONSÓRCIO LTDA.;Oferta ou prestação de informação a respeito de produtos e serviços de forma inadequada por administradora de consórcio;4;1;0;5;
2023;2º;47658539;CONSÓRCIO NACIONAL VOLKSWAGEN - ADMINISTRADORA DE CONSÓRCIO LTDA.;Reclamações relacionadas a assuntos diversos;0;0;2;2;
2023;2º;47658539;CONSÓRCIO NACIONAL VOLKSWAGEN - ADMINISTRADORA DE CONSÓRCIO LTDA.;Renegociação de dívida - Consórcio;0;0;3;3;
2023;2º;47658539;CONSÓRCIO NACIONAL VOLKSWAGEN - ADMINISTRADORA DE CONSÓRCIO LTDA.;Restrições cadastrais - Consórcio;0;0;1;1;
2023;2º;58919903;CONVEF ADMINISTRADORA DE CONSÓRCIOS LTDA.;Descumprimento de cláusulas referentes à devolução de valores;0;1;0;1;
2023;2º;58919903;CONVEF ADMINISTRADORA DE CONSÓRCIOS LTDA.;Irregularidades relacionadas a informações e liquidação de valores a receber no sistema SVR do BCB por parte de consórcios;0;2;0;2;
2023;2º;58919903;CONVEF ADMINISTRADORA DE CONSÓRCIOS LTDA.;Irregularidades relativas a integridade, confiabilidade, segurança, sigilo ou legitimidade das operações e serviços prestados relacionados a administradora de consórcio;0;1;0;1;
2023;2º;58919903;CONVEF ADMINISTRADORA DE CONSÓRCIOS LTDA.;Reclamações relacionadas a assuntos diversos;0;0;1;1;
2023;2º;61550836;COOPERATIVA MISTA ROMA;Descumprimento de cláusulas referentes à devolução de valores;0;2;0;2;
2023;2º;61550836;COOPERATIVA MISTA ROMA;Descumprimento de prazo de resposta a demanda;0;1;0;1;
2023;2º;61550836;COOPERATIVA MISTA ROMA;Insatisfação com a resposta fornecida pela administradora de consórcio relativa à demanda registrada contra ela;0;4;0;4;
2023;2º;61550836;COOPERATIVA MISTA ROMA;Irregularidades relativas a integridade, confiabilidade, segurança, sigilo ou legitimidade das operações e serviços prestados relacionados a administradora de consórcio;0;2;0;2;
2023;2º;61550836;COOPERATIVA MISTA ROMA;Não fornecimento, remessa ou divulgação de documentos por parte de administradora de consórcio;0;1;0;1;
2023;2º;61550836;COOPERATIVA MISTA ROMA;Oferta ou prestação de informação a respeito de produtos e serviços de forma inadequada por administradora de consórcio;32;11;0;43;
2023;2º;59395061;DISAL ADMINISTRADORA DE CONSÓRCIOS LTDA;Cancelamento de contrato a pedido do cliente não atendido por administradora de consórcio;0;1;0;1;
2023;2º;59395061;DISAL ADMINISTRADORA DE CONSÓRCIOS LTDA;Descumprimento de cláusulas referentes à devolução de valores;4;5;0;9;
2023;2º;59395061;DISAL ADMINISTRADORA DE CONSÓRCIOS LTDA;Descumprimento de obrigações previstas em contratos;1;4;0;5;
2023;2º;59395061;DISAL ADMINISTRADORA DE CONSÓRCIOS LTDA;Descumprimento de prazo de resposta a demanda;1;0;0;1;
2023;2º;59395061;DISAL ADMINISTRADORA DE CONSÓRCIOS LTDA;Falta de transparência na redação de documentos por parte de administradora de consórcio;0;1;0;1;
2023;2º;59395061;DISAL ADMINISTRADORA DE CONSÓRCIOS LTDA;Insatisfação com a resposta fornecida pela administradora de consórcio relativa à demanda registrada contra ela;3;4;0;7;
2023;2º;59395061;DISAL ADMINISTRADORA DE CONSÓRCIOS LTDA;Irregularidades relacionadas a informações e liquidação de valores a receber no sistema SVR do BCB por parte de consórcios;0;3;0;3;
2023;2º;59395061;DISAL ADMINISTRADORA DE CONSÓRCIOS LTDA;Irregularidades relacionadas à liberação do crédito;4;5;0;9;
2023;2º;59395061;DISAL ADMINISTRADORA DE CONSÓRCIOS LTDA;Irregularidades relacionadas às condições para contemplação por lance ou sorteio;0;1;0;1;
2023;2º;59395061;DISAL ADMINISTRADORA DE CONSÓRCIOS LTDA;Irregularidades relativas a integridade, confiabilidade, segurança, sigilo ou legitimidade das operações e serviços prestados relacionados a administradora de consórcio;9;8;0;17;
2023;2º;59395061;DISAL ADMINISTRADORA DE CONSÓRCIOS LTDA;Não fornecimento, remessa ou divulgação de documentos por parte de administradora de consórcio;2;1;0;3;
2023;2º;59395061;DISAL ADMINISTRADORA DE CONSÓRCIOS LTDA;Oferta ou prestação de informação a respeito de produtos e serviços de forma inadequada por administradora de consórcio;6;2;0;8;
2023;2º;59395061;DISAL ADMINISTRADORA DE CONSÓRCIOS LTDA;Recusa de produtos ou serviços - Consórcio;0;0;1;1;
2023;2º;01659838;DISBRAVE ADMINISTRADORA DE CONSORCIOS LTDA.;Cancelamento de contrato a pedido do cliente não atendido por administradora de consórcio;0;1;0;1;
2023;2º;01659838;DISBRAVE ADMINISTRADORA DE CONSORCIOS LTDA.;Irregularidades relacionadas a informações e liquidação de valores a receber no sistema SVR do BCB por parte de consórcios;1;0;0;1;
2023;2º;01659838;DISBRAVE ADMINISTRADORA DE CONSORCIOS LTDA.;Irregularidades relacionadas à liberação do crédito;0;1;0;1;
2023;2º;01659838;DISBRAVE ADMINISTRADORA DE CONSORCIOS LTDA.;Irregularidades relacionadas às condições para contemplação por lance ou sorteio;0;5;0;5;
2023;2º;01659838;DISBRAVE ADMINISTRADORA DE CONSORCIOS LTDA.;Irregularidades relativas a integridade, confiabilidade, segurança, sigilo ou legitimidade das operações e serviços prestados relacionados a administradora de consórcio;3;2;0;5;
2023;2º;01659838;DISBRAVE ADMINISTRADORA DE CONSORCIOS LTDA.;Não fornecimento, remessa ou divulgação de documentos por parte de administradora de consórcio;1;2;0;3;
2023;2º;01659838;DISBRAVE ADMINISTRADORA DE CONSORCIOS LTDA.;Oferta ou prestação de informação a respeito de produtos e serviços de forma inadequada por administradora de consórcio;0;1;0;1;
2023;2º;58113812;EMBRACON ADMINISTRADORA DE CONSÓRCIO LTDA;Cancelamento de contrato a pedido do cliente não atendido por administradora de consórcio;3;2;0;5;
2023;2º;58113812;EMBRACON ADMINISTRADORA DE CONSÓRCIO LTDA;Cobrança irregular de tarifa pela emissão de boletos, carnês e assemelhados;0;1;0;1;
2023;2º;58113812;EMBRACON ADMINISTRADORA DE CONSÓRCIO LTDA;Cobranças Diversas - Consórcio;0;0;2;2;
2023;2º;58113812;EMBRACON ADMINISTRADORA DE CONSÓRCIO LTDA;Descumprimento de cláusulas referentes à devolução de valores;13;36;0;49;
2023;2º;58113812;EMBRACON ADMINISTRADORA DE CONSÓRCIO LTDA;Descumprimento de obrigações previstas em contratos;0;3;0;3;
2023;2º;58113812;EMBRACON ADMINISTRADORA DE CONSÓRCIO LTDA;Descumprimento de ordem judicial - Consórcio;0;0;1;1;
2023;2º;58113812;EMBRACON ADMINISTRADORA DE CONSÓRCIO LTDA;Falta de transparência na redação de documentos por parte de administradora de consórcio;2;0;0;2;
2023;2º;58113812;EMBRACON ADMINISTRADORA DE CONSÓRCIO LTDA;Insatisfação com a resposta fornecida pela administradora de consórcio relativa à demanda registrada contra ela;4;14;0;18;
2023;2º;58113812;EMBRACON ADMINISTRADORA DE CONSÓRCIO LTDA;Insatisfação por parte do cliente com o atendimento prestado pela administradora de consórcio;0;0;1;1;
2023;2º;58113812;EMBRACON ADMINISTRADORA DE CONSÓRCIO LTDA;Irregularidades relacionadas a informações e liquidação de valores a receber no sistema SVR do BCB por parte de consórcios;2;6;0;8;
2023;2º;58113812;EMBRACON ADMINISTRADORA DE CONSÓRCIO LTDA;Irregularidades relacionadas à liberação do crédito;6;25;0;31;
2023;2º;58113812;EMBRACON ADMINISTRADORA DE CONSÓRCIO LTDA;Irregularidades relacionadas às condições para contemplação por lance ou sorteio;0;4;0;4;
2023;2º;58113812;EMBRACON ADMINISTRADORA DE CONSÓRCIO LTDA;Irregularidades relativas a integridade, confiabilidade, segurança, sigilo ou legitimidade das operações e serviços prestados relacionados a administradora de consórcio;36;17;0;53;
2023;2º;58113812;EMBRACON ADMINISTRADORA DE CONSÓRCIO LTDA;Irregularidades relativas a telemarketing, SMS ou WhatsApp com oferta de Consórcio;0;0;1;1;
2023;2º;58113812;EMBRACON ADMINISTRADORA DE CONSÓRCIO LTDA;Não fornecimento, remessa ou divulgação de documentos por parte de administradora de consórcio;1;6;0;7;
2023;2º;58113812;EMBRACON ADMINISTRADORA DE CONSÓRCIO LTDA;Oferta ou prestação de informação a respeito de produtos e serviços de forma inadequada por administradora de consórcio;31;8;0;39;
2023;2º;58113812;EMBRACON ADMINISTRADORA DE CONSÓRCIO LTDA;Reclamações relacionadas a assuntos diversos;0;0;1;1;
2023;2º;58113812;EMBRACON ADMINISTRADORA DE CONSÓRCIO LTDA;Renegociação de dívida - Consórcio;0;0;2;2;
2023;2º;42735881;EVOY ADMINISTRADORA DE CONSORCIO LTDA.;Descumprimento de cláusulas referentes à devolução de valores;0;1;0;1;
2023;2º;42735881;EVOY ADMINISTRADORA DE CONSORCIO LTDA.;Oferta ou prestação de informação a respeito de produtos e serviços de forma inadequada por administradora de consórcio;0;1;0;1;
2023;2º;91107581;FARROUPILHA ADMINISTRADORA DE CONSÓRCIOS LTDA.;Descumprimento de cláusulas referentes à devolução de valores;0;1;0;1;
2023;2º;91107581;FARROUPILHA ADMINISTRADORA DE CONSÓRCIOS LTDA.;Irregularidades relacionadas a informações e liquidação de valores a receber no sistema SVR do BCB por parte de consórcios;2;1;0;3;
2023;2º;91107581;FARROUPILHA ADMINISTRADORA DE CONSÓRCIOS LTDA.;Irregularidades relacionadas à liberação do crédito;0;1;0;1;
2023;2º;91107581;FARROUPILHA ADMINISTRADORA DE CONSÓRCIOS LTDA.;Não fornecimento, remessa ou divulgação de documentos por parte de administradora de consórcio;1;0;0;1;
2023;2º;45725975;FINAMA ADMINISTRADORA DE CONSORCIO LTDA;Cancelamento de contrato a pedido do cliente não atendido por administradora de consórcio;1;0;0;1;
2023;2º;45725975;FINAMA ADMINISTRADORA DE CONSORCIO LTDA;Irregularidades relacionadas à liberação do crédito;0;1;0;1;
2023;2º;45725975;FINAMA ADMINISTRADORA DE CONSORCIO LTDA;Irregularidades relacionadas às condições para contemplação por lance ou sorteio;0;1;0;1;
2023;2º;00643742;FUNDACAO HABITACIONAL DO EXERCITO - FHE;Irregularidades relativas a integridade, confiabilidade, segurança, sigilo ou legitimidade das operações e serviços prestados relacionados a administradora de consórcio;0;1;0;1;
2023;2º;94187879;GGS ADMINISTRADORA DE CONSÓRCIOS LTDA.;Irregularidades relativas a integridade, confiabilidade, segurança, sigilo ou legitimidade das operações e serviços prestados relacionados a administradora de consórcio;1;0;0;1;
2023;2º;94187879;GGS ADMINISTRADORA DE CONSÓRCIOS LTDA.;Não fornecimento, remessa ou divulgação de documentos por parte de administradora de consórcio;1;1;0;2;
2023;2º;85322204;GLOBO ADMINISTRADORA DE CONSÓRCIOS LTDA.;Irregularidades relacionadas a informações e liquidação de valores a receber no sistema SVR do BCB por parte de consórcios;0;1;0;1;
2023;2º;49937055;GMAC ADMINISTRADORA DE CONSORCIOS LTDA;Cancelamento de contrato a pedido do cliente não atendido por administradora de consórcio;1;0;0;1;
2023;2º;49937055;GMAC ADMINISTRADORA DE CONSORCIOS LTDA;Descumprimento de cláusulas referentes à devolução de valores;6;5;0;11;
2023;2º;49937055;GMAC ADMINISTRADORA DE CONSORCIOS LTDA;Descumprimento de obrigações previstas em contratos;0;2;0;2;
2023;2º;49937055;GMAC ADMINISTRADORA DE CONSORCIOS LTDA;Insatisfação com a resposta fornecida pela administradora de consórcio relativa à demanda registrada contra ela;0;2;0;2;
2023;2º;49937055;GMAC ADMINISTRADORA DE CONSORCIOS LTDA;Insatisfação por parte do cliente com o atendimento prestado pela administradora de consórcio;0;0;1;1;
2023;2º;49937055;GMAC ADMINISTRADORA DE CONSORCIOS LTDA;Irregularidades relacionadas a informações e liquidação de valores a receber no sistema SVR do BCB por parte de consórcios;6;6;0;12;
2023;2º;49937055;GMAC ADMINISTRADORA DE CONSORCIOS LTDA;Irregularidades relacionadas à liberação do crédito;2;4;0;6;
2023;2º;49937055;GMAC ADMINISTRADORA DE CONSORCIOS LTDA;Irregularidades relacionadas às condições para contemplação por lance ou sorteio;1;0;0;1;
2023;2º;49937055;GMAC ADMINISTRADORA DE CONSORCIOS LTDA;Irregularidades relativas a integridade, confiabilidade, segurança, sigilo ou legitimidade das operações e serviços prestados relacionados a administradora de consórcio;9;3;0;12;
2023;2º;49937055;GMAC ADMINISTRADORA DE CONSORCIOS LTDA;Não fornecimento, remessa ou divulgação de documentos por parte de administradora de consórcio;3;2;0;5;
2023;2º;49937055;GMAC ADMINISTRADORA DE CONSORCIOS LTDA;Oferta ou prestação de informação a respeito de produtos e serviços de forma inadequada por administradora de consórcio;10;1;0;11;
2023;2º;49937055;GMAC ADMINISTRADORA DE CONSORCIOS LTDA;Reclamações relacionadas a assuntos diversos;0;0;2;2;
2023;2º;49937055;GMAC ADMINISTRADORA DE CONSORCIOS LTDA;Renegociação de dívida - Consórcio;0;0;1;1;
2023;2º;26228270;GROSCON ADMINISTRADORA DE CONSORCIOS LTDA.;Insatisfação com a resposta fornecida pela administradora de consórcio relativa à demanda registrada contra ela;0;1;0;1;
2023;2º;73516106;HS ADMINISTRADORA DE CONSÓRCIOS LTDA;Descumprimento de cláusulas referentes à devolução de valores;0;1;0;1;
2023;2º;73516106;HS ADMINISTRADORA DE CONSÓRCIOS LTDA;Insatisfação por parte do cliente com o atendimento prestado pela administradora de consórcio;0;0;1;1;
2023;2º;73516106;HS ADMINISTRADORA DE CONSÓRCIOS LTDA;Irregularidades relacionadas a informações e liquidação de valores a receber no sistema SVR do BCB por parte de consórcios;0;1;0;1;
2023;2º;73516106;HS ADMINISTRADORA DE CONSÓRCIOS LTDA;Irregularidades relacionadas à liberação do crédito;2;7;0;9;
2023;2º;73516106;HS ADMINISTRADORA DE CONSÓRCIOS LTDA;Irregularidades relacionadas às condições para contemplação por lance ou sorteio;0;2;0;2;
2023;2º;73516106;HS ADMINISTRADORA DE CONSÓRCIOS LTDA;Irregularidades relativas a integridade, confiabilidade, segurança, sigilo ou legitimidade das operações e serviços prestados relacionados a administradora de consórcio;4;3;0;7;
2023;2º;73516106;HS ADMINISTRADORA DE CONSÓRCIOS LTDA;Não fornecimento, remessa ou divulgação de documentos por parte de administradora de consórcio;2;0;0;2;
2023;2º;73516106;HS ADMINISTRADORA DE CONSÓRCIOS LTDA;Oferta ou prestação de informação a respeito de produtos e serviços de forma inadequada por administradora de consórcio;2;2;0;4;
2023;2º;73516106;HS ADMINISTRADORA DE CONSÓRCIOS LTDA;Recusa de produtos ou serviços - Consórcio;0;0;1;1;
2023;2º;00000776;ITAÚ ADMINISTRADORA DE CONSÓRCIOS LTDA.;Cancelamento de contrato a pedido do cliente não atendido por administradora de consórcio;2;1;0;3;
2023;2º;00000776;ITAÚ ADMINISTRADORA DE CONSÓRCIOS LTDA.;Cobranças Diversas - Consórcio;0;0;1;1;
2023;2º;00000776;ITAÚ ADMINISTRADORA DE CONSÓRCIOS LTDA.;Descumprimento de cláusulas referentes à devolução de valores;5;14;0;19;
2023;2º;00000776;ITAÚ ADMINISTRADORA DE CONSÓRCIOS LTDA.;Descumprimento de obrigações previstas em contratos;2;1;0;3;
2023;2º;00000776;ITAÚ ADMINISTRADORA DE CONSÓRCIOS LTDA.;Descumprimento de ordem judicial - Consórcio;0;0;1;1;
2023;2º;00000776;ITAÚ ADMINISTRADORA DE CONSÓRCIOS LTDA.;Descumprimento de prazo de resposta a demanda;0;1;0;1;
2023;2º;00000776;ITAÚ ADMINISTRADORA DE CONSÓRCIOS LTDA.;Insatisfação com a resposta fornecida pela administradora de consórcio relativa à demanda registrada contra ela;3;9;0;12;
2023;2º;00000776;ITAÚ ADMINISTRADORA DE CONSÓRCIOS LTDA.;Insatisfação por parte do cliente com o atendimento prestado pela administradora de consórcio;0;0;2;2;
2023;2º;00000776;ITAÚ ADMINISTRADORA DE CONSÓRCIOS LTDA.;Irregularidades relacionadas a informações e liquidação de valores a receber no sistema SVR do BCB por parte de consórcios;4;0;0;4;
2023;2º;00000776;ITAÚ ADMINISTRADORA DE CONSÓRCIOS LTDA.;Irregularidades relacionadas à liberação do crédito;10;12;0;22;
2023;2º;00000776;ITAÚ ADMINISTRADORA DE CONSÓRCIOS LTDA.;Irregularidades relacionadas às condições para contemplação por lance ou sorteio;1;9;0;10;
2023;2º;00000776;ITAÚ ADMINISTRADORA DE CONSÓRCIOS LTDA.;Irregularidades relativas a integridade, confiabilidade, segurança, sigilo ou legitimidade das operações e serviços prestados relacionados a administradora de consórcio;48;20;0;68;
2023;2º;00000776;ITAÚ ADMINISTRADORA DE CONSÓRCIOS LTDA.;Não fornecimento, remessa ou divulgação de documentos por parte de administradora de consórcio;7;4;0;11;
2023;2º;00000776;ITAÚ ADMINISTRADORA DE CONSÓRCIOS LTDA.;Oferta ou prestação de informação a respeito de produtos e serviços de forma inadequada por administradora de consórcio;23;12;0;35;
2023;2º;00000776;ITAÚ ADMINISTRADORA DE CONSÓRCIOS LTDA.;Reclamações relacionadas a assuntos diversos;0;0;1;1;
2023;2º;00000776;ITAÚ ADMINISTRADORA DE CONSÓRCIOS LTDA.;Recusa de produtos ou serviços - Consórcio;0;0;4;4;
2023;2º;00000776;ITAÚ ADMINISTRADORA DE CONSÓRCIOS LTDA.;Renegociação de dívida - Consórcio;0;0;1;1;
2023;2º;00000776;ITAÚ ADMINISTRADORA DE CONSÓRCIOS LTDA.;Restrições cadastrais - Consórcio;0;0;1;1;
2023;2º;41629070;KLUBI ADMINISTRADORA DE CONSÓRCIOS LTDA.;Insatisfação por parte do cliente com o atendimento prestado pela administradora de consórcio;0;0;1;1;
2023;2º;41629070;KLUBI ADMINISTRADORA DE CONSÓRCIOS LTDA.;Irregularidades relativas a telemarketing, SMS ou WhatsApp com oferta de Consórcio;0;0;1;1;
2023;2º;41629070;KLUBI ADMINISTRADORA DE CONSÓRCIOS LTDA.;Oferta ou prestação de informação a respeito de produtos e serviços de forma inadequada por administradora de consórcio;1;0;0;1;
2023;2º;60250776;LUIZA ADMINISTRADORA DE CONSÓRCIOS LTDA;Cancelamento de contrato a pedido do cliente não atendido por administradora de consórcio;1;1;0;2;
2023;2º;60250776;LUIZA ADMINISTRADORA DE CONSÓRCIOS LTDA;Descumprimento de cláusulas referentes à devolução de valores;1;1;0;2;
2023;2º;60250776;LUIZA ADMINISTRADORA DE CONSÓRCIOS LTDA;Descumprimento de obrigações previstas em contratos;0;1;0;1;
2023;2º;60250776;LUIZA ADMINISTRADORA DE CONSÓRCIOS LTDA;Insatisfação com a resposta fornecida pela administradora de consórcio relativa à demanda registrada contra ela;0;1;0;1;
2023;2º;60250776;LUIZA ADMINISTRADORA DE CONSÓRCIOS LTDA;Irregularidades relacionadas a informações e liquidação de valores a receber no sistema SVR do BCB por parte de consórcios;2;0;0;2;
2023;2º;60250776;LUIZA ADMINISTRADORA DE CONSÓRCIOS LTDA;Irregularidades relacionadas à liberação do crédito;0;2;0;2;
2023;2º;60250776;LUIZA ADMINISTRADORA DE CONSÓRCIOS LTDA;Irregularidades relacionadas às condições para contemplação por lance ou sorteio;0;2;0;2;
2023;2º;60250776;LUIZA ADMINISTRADORA DE CONSÓRCIOS LTDA;Irregularidades relativas a integridade, confiabilidade, segurança, sigilo ou legitimidade das operações e serviços prestados relacionados a administradora de consórcio;2;4;0;6;
2023;2º;60250776;LUIZA ADMINISTRADORA DE CONSÓRCIOS LTDA;Não fornecimento, remessa ou divulgação de documentos por parte de administradora de consórcio;0;1;0;1;
2023;2º;60250776;LUIZA ADMINISTRADORA DE CONSÓRCIOS LTDA;Oferta ou prestação de informação a respeito de produtos e serviços de forma inadequada por administradora de consórcio;1;1;0;2;
2023;2º;04250224;MAGGI ADMINISTRADORA DE CONSÓRCIOS LTDA;Descumprimento de cláusulas referentes à devolução de valores;0;1;0;1;
2023;2º;04250224;MAGGI ADMINISTRADORA DE CONSÓRCIOS LTDA;Irregularidades relacionadas à liberação do crédito;2;0;0;2;
2023;2º;04250224;MAGGI ADMINISTRADORA DE CONSÓRCIOS LTDA;Irregularidades relativas a integridade, confiabilidade, segurança, sigilo ou legitimidade das operações e serviços prestados relacionados a administradora de consórcio;1;0;0;1;
2023;2º;45793395;MASSEY FERGUSON ADMINISTRADORA DE CONSÓRCIOS LTDA;Cancelamento de contrato a pedido do cliente não atendido por administradora de consórcio;1;0;0;1;
2023;2º;46349106;MERCABENCO ADMINISTRADORA DE CONSORCIO LTDA;Descumprimento de cláusulas referentes à devolução de valores;0;1;0;1;
2023;2º;04124922;MULTIMARCAS ADMINISTRADORA DE CONSORCIOS LTDA.;Cancelamento de contrato a pedido do cliente não atendido por administradora de consórcio;0;1;0;1;
2023;2º;04124922;MULTIMARCAS ADMINISTRADORA DE CONSORCIOS LTDA.;Descumprimento de cláusulas referentes à devolução de valores;0;3;0;3;
2023;2º;04124922;MULTIMARCAS ADMINISTRADORA DE CONSORCIOS LTDA.;Descumprimento de obrigações previstas em contratos;1;2;0;3;
2023;2º;04124922;MULTIMARCAS ADMINISTRADORA DE CONSORCIOS LTDA.;Insatisfação com a resposta fornecida pela administradora de consórcio relativa à demanda registrada contra ela;2;0;0;2;
2023;2º;04124922;MULTIMARCAS ADMINISTRADORA DE CONSORCIOS LTDA.;Insatisfação por parte do cliente com o atendimento prestado pela administradora de consórcio;0;0;1;1;
2023;2º;04124922;MULTIMARCAS ADMINISTRADORA DE CONSORCIOS LTDA.;Irregularidades relacionadas a informações e liquidação de valores a receber no sistema SVR do BCB por parte de consórcios;1;1;0;2;
2023;2º;04124922;MULTIMARCAS ADMINISTRADORA DE CONSORCIOS LTDA.;Irregularidades relacionadas à liberação do crédito;0;2;0;2;
2023;2º;04124922;MULTIMARCAS ADMINISTRADORA DE CONSORCIOS LTDA.;Irregularidades relacionadas às condições para contemplação por lance ou sorteio;0;1;0;1;
2023;2º;04124922;MULTIMARCAS ADMINISTRADORA DE CONSORCIOS LTDA.;Irregularidades relativas a integridade, confiabilidade, segurança, sigilo ou legitimidade das operações e serviços prestados relacionados a administradora de consórcio;2;2;0;4;
2023;2º;04124922;MULTIMARCAS ADMINISTRADORA DE CONSORCIOS LTDA.;Não fornecimento, remessa ou divulgação de documentos por parte de administradora de consórcio;1;0;0;1;
2023;2º;04124922;MULTIMARCAS ADMINISTRADORA DE CONSORCIOS LTDA.;Oferta ou prestação de informação a respeito de produtos e serviços de forma inadequada por administradora de consórcio;13;9;0;22;
2023;2º;04124922;MULTIMARCAS ADMINISTRADORA DE CONSORCIOS LTDA.;Renegociação de dívida - Consórcio;0;0;2;2;
2023;2º;50533876;PAN ADMINISTRADORA DE CONSORCIO LTDA;Irregularidades relativas a integridade, confiabilidade, segurança, sigilo ou legitimidade das operações e serviços prestados relacionados a administradora de consórcio;1;0;0;1;
2023;2º;50533876;PAN ADMINISTRADORA DE CONSORCIO LTDA;Oferta ou prestação de informação a respeito de produtos e serviços de forma inadequada por administradora de consórcio;0;1;0;1;
2023;2º;48041735;PORTO SEGURO ADMINISTRADORA DE CONSÓRCIOS LTDA;Cancelamento de contrato a pedido do cliente não atendido por administradora de consórcio;2;2;0;4;
2023;2º;48041735;PORTO SEGURO ADMINISTRADORA DE CONSÓRCIOS LTDA;Cobrança irregular de tarifa pela emissão de boletos, carnês e assemelhados;0;1;0;1;
2023;2º;48041735;PORTO SEGURO ADMINISTRADORA DE CONSÓRCIOS LTDA;Cobranças Diversas - Consórcio;0;0;2;2;
2023;2º;48041735;PORTO SEGURO ADMINISTRADORA DE CONSÓRCIOS LTDA;Descumprimento de cláusulas referentes à devolução de valores;13;8;0;21;
2023;2º;48041735;PORTO SEGURO ADMINISTRADORA DE CONSÓRCIOS LTDA;Descumprimento de obrigações previstas em contratos;0;4;0;4;
2023;2º;48041735;PORTO SEGURO ADMINISTRADORA DE CONSÓRCIOS LTDA;Falta de transparência na redação de documentos por parte de administradora de consórcio;1;0;0;1;
2023;2º;48041735;PORTO SEGURO ADMINISTRADORA DE CONSÓRCIOS LTDA;Insatisfação com a resposta fornecida pela administradora de consórcio relativa à demanda registrada contra ela;4;7;0;11;
2023;2º;48041735;PORTO SEGURO ADMINISTRADORA DE CONSÓRCIOS LTDA;Insatisfação por parte do cliente com o atendimento prestado pela administradora de consórcio;0;0;2;2;
2023;2º;48041735;PORTO SEGURO ADMINISTRADORA DE CONSÓRCIOS LTDA;Irregularidades relacionadas a informações e liquidação de valores a receber no sistema SVR do BCB por parte de consórcios;6;16;0;22;
2023;2º;48041735;PORTO SEGURO ADMINISTRADORA DE CONSÓRCIOS LTDA;Irregularidades relacionadas à liberação do crédito;20;22;0;42;
2023;2º;48041735;PORTO SEGURO ADMINISTRADORA DE CONSÓRCIOS LTDA;Irregularidades relativas a integridade, confiabilidade, segurança, sigilo ou legitimidade das operações e serviços prestados relacionados a administradora de consórcio;82;21;0;103;
2023;2º;48041735;PORTO SEGURO ADMINISTRADORA DE CONSÓRCIOS LTDA;Irregularidades relativas a telemarketing, SMS ou WhatsApp com oferta de Consórcio;0;0;3;3;
2023;2º;48041735;PORTO SEGURO ADMINISTRADORA DE CONSÓRCIOS LTDA;Não fornecimento, remessa ou divulgação de documentos por parte de administradora de consórcio;5;3;0;8;
2023;2º;48041735;PORTO SEGURO ADMINISTRADORA DE CONSÓRCIOS LTDA;Oferta ou prestação de informação a respeito de produtos e serviços de forma inadequada por administradora de consórcio;16;0;0;16;
2023;2º;48041735;PORTO SEGURO ADMINISTRADORA DE CONSÓRCIOS LTDA;Outras irregularidades;0;1;0;1;
2023;2º;48041735;PORTO SEGURO ADMINISTRADORA DE CONSÓRCIOS LTDA;Reclamações relacionadas a assuntos diversos;0;0;4;4;
2023;2º;48041735;PORTO SEGURO ADMINISTRADORA DE CONSÓRCIOS LTDA;Recusa de produtos ou serviços - Consórcio;0;0;1;1;
2023;2º;48041735;PORTO SEGURO ADMINISTRADORA DE CONSÓRCIOS LTDA;Renegociação de dívida - Consórcio;0;0;5;5;
2023;2º;48041735;PORTO SEGURO ADMINISTRADORA DE CONSÓRCIOS LTDA;Restrições cadastrais - Consórcio;0;0;1;1;
2023;2º;87433413;PORTOBENS ADMINISTRADORA DE CONSORCIOS LTDA;Descumprimento de obrigações previstas em contratos;0;1;0;1;
2023;2º;87433413;PORTOBENS ADMINISTRADORA DE CONSORCIOS LTDA;Irregularidades relativas a integridade, confiabilidade, segurança, sigilo ou legitimidade das operações e serviços prestados relacionados a administradora de consórcio;2;0;0;2;
2023;2º;51597300;PRIMO ROSSI ADMINISTRADORA DE CONSÓRCIO LTDA.;Descumprimento de cláusulas referentes à devolução de valores;0;1;0;1;
2023;2º;51597300;PRIMO ROSSI ADMINISTRADORA DE CONSÓRCIO LTDA.;Não fornecimento, remessa ou divulgação de documentos por parte de administradora de consórcio;0;1;0;1;
2023;2º;51597300;PRIMO ROSSI ADMINISTRADORA DE CONSÓRCIO LTDA.;Renegociação de dívida - Consórcio;0;0;1;1;
2023;2º;09111444;PROMOVE ADMINISTRADORA DE CONSÓRCIO LTDA.;Cancelamento de contrato a pedido do cliente não atendido por administradora de consórcio;0;1;0;1;
2023;2º;09111444;PROMOVE ADMINISTRADORA DE CONSÓRCIO LTDA.;Descumprimento de prazo de resposta a demanda;0;1;0;1;
2023;2º;09111444;PROMOVE ADMINISTRADORA DE CONSÓRCIO LTDA.;Insatisfação com a resposta fornecida pela administradora de consórcio relativa à demanda registrada contra ela;0;3;0;3;
2023;2º;09111444;PROMOVE ADMINISTRADORA DE CONSÓRCIO LTDA.;Oferta ou prestação de informação a respeito de produtos e serviços de forma inadequada por administradora de consórcio;10;3;0;13;
2023;2º;91108027;RANDON ADMINISTRADORA DE CONSÓRCIOS LTDA.;Descumprimento de obrigações previstas em contratos;0;1;0;1;
2023;2º;91108027;RANDON ADMINISTRADORA DE CONSÓRCIOS LTDA.;Irregularidades relacionadas às condições para contemplação por lance ou sorteio;0;1;0;1;
2023;2º;91108027;RANDON ADMINISTRADORA DE CONSÓRCIOS LTDA.;Irregularidades relativas a integridade, confiabilidade, segurança, sigilo ou legitimidade das operações e serviços prestados relacionados a administradora de consórcio;0;1;0;1;
2023;2º;91108027;RANDON ADMINISTRADORA DE CONSÓRCIOS LTDA.;Oferta ou prestação de informação a respeito de produtos e serviços de forma inadequada por administradora de consórcio;1;0;0;1;
2023;2º;06181431;RCN ADMINISTRADORA DE CONSORCIO NACIONAL LTDA;Cancelamento de contrato a pedido do cliente não atendido por administradora de consórcio;0;1;0;1;
2023;2º;06181431;RCN ADMINISTRADORA DE CONSORCIO NACIONAL LTDA;Descumprimento de cláusulas referentes à devolução de valores;0;1;0;1;
2023;2º;06181431;RCN ADMINISTRADORA DE CONSORCIO NACIONAL LTDA;Insatisfação com a resposta fornecida pela administradora de consórcio relativa à demanda registrada contra ela;0;1;0;1;
2023;2º;06181431;RCN ADMINISTRADORA DE CONSORCIO NACIONAL LTDA;Oferta ou prestação de informação a respeito de produtos e serviços de forma inadequada por administradora de consórcio;11;3;0;14;
2023;2º;23767155;RECON ADMINISTRADORA DE CONSORCIOS LTDA;Descumprimento de cláusulas referentes à devolução de valores;1;0;0;1;
2023;2º;23767155;RECON ADMINISTRADORA DE CONSORCIOS LTDA;Insatisfação com a resposta fornecida pela administradora de consórcio relativa à demanda registrada contra ela;0;1;0;1;
2023;2º;23767155;RECON ADMINISTRADORA DE CONSORCIOS LTDA;Irregularidades relativas a integridade, confiabilidade, segurança, sigilo ou legitimidade das operações e serviços prestados relacionados a administradora de consórcio;1;0;0;1;
2023;2º;23767155;RECON ADMINISTRADORA DE CONSORCIOS LTDA;Oferta ou prestação de informação a respeito de produtos e serviços de forma inadequada por administradora de consórcio;3;0;0;3;
2023;2º;62354055;REMAZA ADMINISTRADORA DE CONSÓRCIO LTDA.;Descumprimento de cláusulas referentes à devolução de valores;0;4;0;4;
2023;2º;62354055;REMAZA ADMINISTRADORA DE CONSÓRCIO LTDA.;Falta de transparência na redação de documentos por parte de administradora de consórcio;1;0;0;1;
2023;2º;62354055;REMAZA ADMINISTRADORA DE CONSÓRCIO LTDA.;Insatisfação com a resposta fornecida pela administradora de consórcio relativa à demanda registrada contra ela;0;2;0;2;
2023;2º;62354055;REMAZA ADMINISTRADORA DE CONSÓRCIO LTDA.;Irregularidades relacionadas à liberação do crédito;0;3;0;3;
2023;2º;62354055;REMAZA ADMINISTRADORA DE CONSÓRCIO LTDA.;Irregularidades relativas a integridade, confiabilidade, segurança, sigilo ou legitimidade das operações e serviços prestados relacionados a administradora de consórcio;0;3;0;3;
2023;2º;62354055;REMAZA ADMINISTRADORA DE CONSÓRCIO LTDA.;Oferta ou prestação de informação a respeito de produtos e serviços de forma inadequada por administradora de consórcio;0;1;0;1;
2023;2º;28904092;RESERVA ADMINISTRADORA DE CONSÓRCIO LTDA;Cancelamento de contrato a pedido do cliente não atendido por administradora de consórcio;1;0;0;1;
2023;2º;28904092;RESERVA ADMINISTRADORA DE CONSÓRCIO LTDA;Descumprimento de cláusulas referentes à devolução de valores;0;5;0;5;
2023;2º;28904092;RESERVA ADMINISTRADORA DE CONSÓRCIO LTDA;Insatisfação com a resposta fornecida pela administradora de consórcio relativa à demanda registrada contra ela;2;3;0;5;
2023;2º;28904092;RESERVA ADMINISTRADORA DE CONSÓRCIO LTDA;Irregularidades relacionadas à liberação do crédito;0;1;0;1;
2023;2º;28904092;RESERVA ADMINISTRADORA DE CONSÓRCIO LTDA;Irregularidades relativas a integridade, confiabilidade, segurança, sigilo ou legitimidade das operações e serviços prestados relacionados a administradora de consórcio;1;0;0;1;
2023;2º;28904092;RESERVA ADMINISTRADORA DE CONSÓRCIO LTDA;Não fornecimento, remessa ou divulgação de documentos por parte de administradora de consórcio;0;2;0;2;
2023;2º;28904092;RESERVA ADMINISTRADORA DE CONSÓRCIO LTDA;Oferta ou prestação de informação a respeito de produtos e serviços de forma inadequada por administradora de consórcio;24;4;0;28;
2023;2º;80402746;RIVEL ADMINISTRADORA DE CONSÓRCIOS LTDA.;Irregularidades relacionadas à liberação do crédito;0;1;0;1;
2023;2º;51855716;RODOBENS ADMINISTRADORA DE CONSÓRCIOS LTDA.;Cancelamento de contrato a pedido do cliente não atendido por administradora de consórcio;1;0;0;1;
2023;2º;51855716;RODOBENS ADMINISTRADORA DE CONSÓRCIOS LTDA.;Cobranças Diversas - Consórcio;0;0;2;2;
2023;2º;51855716;RODOBENS ADMINISTRADORA DE CONSÓRCIOS LTDA.;Descumprimento de cláusulas referentes à devolução de valores;1;6;0;7;
2023;2º;51855716;RODOBENS ADMINISTRADORA DE CONSÓRCIOS LTDA.;Descumprimento de obrigações previstas em contratos;0;3;0;3;
2023;2º;51855716;RODOBENS ADMINISTRADORA DE CONSÓRCIOS LTDA.;Insatisfação com a resposta fornecida pela administradora de consórcio relativa à demanda registrada contra ela;1;4;0;5;
2023;2º;51855716;RODOBENS ADMINISTRADORA DE CONSÓRCIOS LTDA.;Insatisfação por parte do cliente com o atendimento prestado pela administradora de consórcio;0;0;2;2;
2023;2º;51855716;RODOBENS ADMINISTRADORA DE CONSÓRCIOS LTDA.;Irregularidades relacionadas a informações e liquidação de valores a receber no sistema SVR do BCB por parte de consórcios;0;6;0;6;
2023;2º;51855716;RODOBENS ADMINISTRADORA DE CONSÓRCIOS LTDA.;Irregularidades relacionadas à liberação do crédito;3;6;0;9;
2023;2º;51855716;RODOBENS ADMINISTRADORA DE CONSÓRCIOS LTDA.;Irregularidades relacionadas às condições para contemplação por lance ou sorteio;0;1;0;1;
2023;2º;51855716;RODOBENS ADMINISTRADORA DE CONSÓRCIOS LTDA.;Irregularidades relativas a integridade, confiabilidade, segurança, sigilo ou legitimidade das operações e serviços prestados relacionados a administradora de consórcio;10;8;0;18;
2023;2º;51855716;RODOBENS ADMINISTRADORA DE CONSÓRCIOS LTDA.;Não fornecimento, remessa ou divulgação de documentos por parte de administradora de consórcio;2;4;0;6;
2023;2º;51855716;RODOBENS ADMINISTRADORA DE CONSÓRCIOS LTDA.;Oferta ou prestação de informação a respeito de produtos e serviços de forma inadequada por administradora de consórcio;3;1;0;4;
2023;2º;51855716;RODOBENS ADMINISTRADORA DE CONSÓRCIOS LTDA.;Renegociação de dívida - Consórcio;0;0;1;1;
2023;2º;55942312;SANTANDER BRASIL ADMINISTRADORA DE CONSÓRCIO LTDA.;Cancelamento de contrato a pedido do cliente não atendido por administradora de consórcio;4;2;0;6;
2023;2º;55942312;SANTANDER BRASIL ADMINISTRADORA DE CONSÓRCIO LTDA.;Descumprimento de cláusulas referentes à devolução de valores;4;9;0;13;
2023;2º;55942312;SANTANDER BRASIL ADMINISTRADORA DE CONSÓRCIO LTDA.;Descumprimento de obrigações previstas em contratos;1;4;0;5;
2023;2º;55942312;SANTANDER BRASIL ADMINISTRADORA DE CONSÓRCIO LTDA.;Descumprimento de ordem judicial - Consórcio;0;0;1;1;
2023;2º;55942312;SANTANDER BRASIL ADMINISTRADORA DE CONSÓRCIO LTDA.;Insatisfação com a resposta fornecida pela administradora de consórcio relativa à demanda registrada contra ela;1;7;0;8;
2023;2º;55942312;SANTANDER BRASIL ADMINISTRADORA DE CONSÓRCIO LTDA.;Insatisfação por parte do cliente com o atendimento prestado pela administradora de consórcio;0;0;2;2;
2023;2º;55942312;SANTANDER BRASIL ADMINISTRADORA DE CONSÓRCIO LTDA.;Irregularidades relacionadas a informações e liquidação de valores a receber no sistema SVR do BCB por parte de consórcios;2;3;0;5;
2023;2º;55942312;SANTANDER BRASIL ADMINISTRADORA DE CONSÓRCIO LTDA.;Irregularidades relacionadas à liberação do crédito;5;12;0;17;
2023;2º;55942312;SANTANDER BRASIL ADMINISTRADORA DE CONSÓRCIO LTDA.;Irregularidades relativas a integridade, confiabilidade, segurança, sigilo ou legitimidade das operações e serviços prestados relacionados a administradora de consórcio;41;30;0;71;
2023;2º;55942312;SANTANDER BRASIL ADMINISTRADORA DE CONSÓRCIO LTDA.;Não fornecimento, remessa ou divulgação de documentos por parte de administradora de consórcio;3;2;0;5;
2023;2º;55942312;SANTANDER BRASIL ADMINISTRADORA DE CONSÓRCIO LTDA.;Oferta ou prestação de informação a respeito de produtos e serviços de forma inadequada por administradora de consórcio;14;1;0;15;
2023;2º;55942312;SANTANDER BRASIL ADMINISTRADORA DE CONSÓRCIO LTDA.;Recusa de produtos ou serviços - Consórcio;0;0;4;4;
2023;2º;55942312;SANTANDER BRASIL ADMINISTRADORA DE CONSÓRCIO LTDA.;Renegociação de dívida - Consórcio;0;0;2;2;
2023;2º;96479258;SCANIA ADMINISTRADORA DE CONSÓRCIOS LTDA.;Irregularidades relativas a integridade, confiabilidade, segurança, sigilo ou legitimidade das operações e serviços prestados relacionados a administradora de consórcio;0;1;0;1;
2023;2º;76515071;SERVOPA ADMINISTRADORA DE CONSORCIOS LTDA;Irregularidades relacionadas a informações e liquidação de valores a receber no sistema SVR do BCB por parte de consórcios;1;0;0;1;
2023;2º;76515071;SERVOPA ADMINISTRADORA DE CONSORCIOS LTDA;Irregularidades relativas a integridade, confiabilidade, segurança, sigilo ou legitimidade das operações e serviços prestados relacionados a administradora de consórcio;0;2;0;2;
2023;2º;16551061;SICOOB ADMINISTRADORA DE CONSÓRCIOS LTDA.;Cobranças Diversas - Consórcio;0;0;1;1;
2023;2º;16551061;SICOOB ADMINISTRADORA DE CONSÓRCIOS LTDA.;Descumprimento de cláusulas referentes à devolução de valores;0;4;0;4;
2023;2º;16551061;SICOOB ADMINISTRADORA DE CONSÓRCIOS LTDA.;Descumprimento de obrigações previstas em contratos;2;5;0;7;
2023;2º;16551061;SICOOB ADMINISTRADORA DE CONSÓRCIOS LTDA.;Insatisfação com a resposta fornecida pela administradora de consórcio relativa à demanda registrada contra ela;0;2;0;2;
2023;2º;16551061;SICOOB ADMINISTRADORA DE CONSÓRCIOS LTDA.;Irregularidades relacionadas a informações e liquidação de valores a receber no sistema SVR do BCB por parte de consórcios;1;0;0;1;
2023;2º;16551061;SICOOB ADMINISTRADORA DE CONSÓRCIOS LTDA.;Irregularidades relacionadas à liberação do crédito;4;13;0;17;
2023;2º;16551061;SICOOB ADMINISTRADORA DE CONSÓRCIOS LTDA.;Irregularidades relativas a integridade, confiabilidade, segurança, sigilo ou legitimidade das operações e serviços prestados relacionados a administradora de consórcio;7;14;0;21;
2023;2º;16551061;SICOOB ADMINISTRADORA DE CONSÓRCIOS LTDA.;Não fornecimento, remessa ou divulgação de documentos por parte de administradora de consórcio;1;2;0;3;
2023;2º;16551061;SICOOB ADMINISTRADORA DE CONSÓRCIOS LTDA.;Oferta ou prestação de informação a respeito de produtos e serviços de forma inadequada por administradora de consórcio;2;0;0;2;
2023;2º;16551061;SICOOB ADMINISTRADORA DE CONSÓRCIOS LTDA.;Reclamações relacionadas a assuntos diversos;0;0;2;2;
2023;2º;16551061;SICOOB ADMINISTRADORA DE CONSÓRCIOS LTDA.;Recusa de produtos ou serviços - Consórcio;0;0;2;2;
2023;2º;16551061;SICOOB ADMINISTRADORA DE CONSÓRCIOS LTDA.;Renegociação de dívida - Consórcio;0;0;1;1;
2023;2º;87945218;SIMPALA LANÇADORA E ADMINISTRADORA DE CONSÓRCIOS LTDA.;Cancelamento de contrato a pedido do cliente não atendido por administradora de consórcio;3;0;0;3;
2023;2º;87945218;SIMPALA LANÇADORA E ADMINISTRADORA DE CONSÓRCIOS LTDA.;Cobrança irregular de tarifa pela emissão de boletos, carnês e assemelhados;0;1;0;1;
2023;2º;87945218;SIMPALA LANÇADORA E ADMINISTRADORA DE CONSÓRCIOS LTDA.;Descumprimento de cláusulas referentes à devolução de valores;1;2;0;3;
2023;2º;87945218;SIMPALA LANÇADORA E ADMINISTRADORA DE CONSÓRCIOS LTDA.;Descumprimento de obrigações previstas em contratos;0;1;0;1;
2023;2º;87945218;SIMPALA LANÇADORA E ADMINISTRADORA DE CONSÓRCIOS LTDA.;Insatisfação com a resposta fornecida pela administradora de consórcio relativa à demanda registrada contra ela;1;1;0;2;
2023;2º;87945218;SIMPALA LANÇADORA E ADMINISTRADORA DE CONSÓRCIOS LTDA.;Insatisfação por parte do cliente com o atendimento prestado pela administradora de consórcio;0;0;4;4;
2023;2º;87945218;SIMPALA LANÇADORA E ADMINISTRADORA DE CONSÓRCIOS LTDA.;Irregularidades relacionadas à liberação do crédito;2;1;0;3;
2023;2º;87945218;SIMPALA LANÇADORA E ADMINISTRADORA DE CONSÓRCIOS LTDA.;Irregularidades relativas a integridade, confiabilidade, segurança, sigilo ou legitimidade das operações e serviços prestados relacionados a administradora de consórcio;13;1;0;14;
2023;2º;87945218;SIMPALA LANÇADORA E ADMINISTRADORA DE CONSÓRCIOS LTDA.;Não fornecimento, remessa ou divulgação de documentos por parte de administradora de consórcio;1;2;0;3;
2023;2º;87945218;SIMPALA LANÇADORA E ADMINISTRADORA DE CONSÓRCIOS LTDA.;Oferta ou prestação de informação a respeito de produtos e serviços de forma inadequada por administradora de consórcio;16;3;0;19;
2023;2º;87852273;SINOSSERRA ADMINISTRADORA DE CONSÓRCIOS LTDA;Não fornecimento, remessa ou divulgação de documentos por parte de administradora de consórcio;0;1;0;1;
2023;2º;57723801;SUZUKI MOTOS ADMINISTRADORA DE CONSÓRCIO LTDA.;Irregularidades relacionadas a informações e liquidação de valores a receber no sistema SVR do BCB por parte de consórcios;1;0;0;1;
2023;2º;43707203;TOYOTA ADMINISTRADORA DE CONSÓRCIOS DO BRASIL LTDA.;Oferta ou prestação de informação a respeito de produtos e serviços de forma inadequada por administradora de consórcio;0;1;0;1;
2023;2º;59956185;TRADIÇÃO ADMINISTRADORA DE CONSÓRCIO LTDA.;Insatisfação com a resposta fornecida pela administradora de consórcio relativa à demanda registrada contra ela;1;0;0;1;
2023;2º;59956185;TRADIÇÃO ADMINISTRADORA DE CONSÓRCIO LTDA.;Oferta ou prestação de informação a respeito de produtos e serviços de forma inadequada por administradora de consórcio;2;1;0;3;
2023;2º;59956185;TRADIÇÃO ADMINISTRADORA DE CONSÓRCIO LTDA.;Reclamações relacionadas a assuntos diversos;0;0;1;1;
2023;2º;78199262;TRIÂNGULO ADMINISTRADORA DE CONSÓRCIOS LTDA;Irregularidades relacionadas às condições para contemplação por lance ou sorteio;0;1;0;1;
2023;2º;60732997;UNIFISA ADMINISTRADORA NACIONAL DE CONSORCIOS LTDA;Cancelamento de contrato a pedido do cliente não atendido por administradora de consórcio;0;1;0;1;
2023;2º;60732997;UNIFISA ADMINISTRADORA NACIONAL DE CONSORCIOS LTDA;Cobrança irregular de tarifa pela emissão de boletos, carnês e assemelhados;0;1;0;1;
2023;2º;60732997;UNIFISA ADMINISTRADORA NACIONAL DE CONSORCIOS LTDA;Descumprimento de obrigações previstas em contratos;0;1;0;1;
2023;2º;60732997;UNIFISA ADMINISTRADORA NACIONAL DE CONSORCIOS LTDA;Irregularidades relacionadas à liberação do crédito;1;2;0;3;
2023;2º;60732997;UNIFISA ADMINISTRADORA NACIONAL DE CONSORCIOS LTDA;Irregularidades relativas a integridade, confiabilidade, segurança, sigilo ou legitimidade das operações e serviços prestados relacionados a administradora de consórcio;0;2;0;2;
2023;2º;60732997;UNIFISA ADMINISTRADORA NACIONAL DE CONSORCIOS LTDA;Oferta ou prestação de informação a respeito de produtos e serviços de forma inadequada por administradora de consórcio;2;4;0;6;
2023;2º;56360266;VALTRA ADMINISTRADORA DE CONSÓRCIOS LTDA;Oferta ou prestação de informação a respeito de produtos e serviços de forma inadequada por administradora de consórcio;1;0;0;1;
2023;2º;22245020;VIVIANI ADMINISTRADORA DE CONSÓRCIO NACIONAL LTDA.;Oferta ou prestação de informação a respeito de produtos e serviços de forma inadequada por administradora de consórcio;1;0;0;1;
2023;2º;50827237;VKN ADMINISTRADORA DE CONSÓRCIO LTDA.;Descumprimento de cláusulas referentes à devolução de valores;1;0;0;1;
2023;2º;74118381;VOLVO ADMINISTRADORA DE CONSÓRCIO LTDA.;Descumprimento de cláusulas referentes à devolução de valores;0;2;0;2;
2023;2º;74118381;VOLVO ADMINISTRADORA DE CONSÓRCIO LTDA.;Reclamações relacionadas a assuntos diversos;0;0;1;1;
2023;2º;40011095;XS5 ADMINISTRADORA DE CONSÓRCIOS S.A.;Cancelamento de contrato a pedido do cliente não atendido por administradora de consórcio;1;1;0;2;
2023;2º;40011095;XS5 ADMINISTRADORA DE CONSÓRCIOS S.A.;Descumprimento de obrigações previstas em contratos;0;2;0;2;
2023;2º;40011095;XS5 ADMINISTRADORA DE CONSÓRCIOS S.A.;Irregularidades relacionadas à liberação do crédito;1;8;0;9;
2023;2º;40011095;XS5 ADMINISTRADORA DE CONSÓRCIOS S.A.;Irregularidades relacionadas às condições para contemplação por lance ou sorteio;0;1;0;1;
2023;2º;40011095;XS5 ADMINISTRADORA DE CONSÓRCIOS S.A.;Irregularidades relativas a integridade, confiabilidade, segurança, sigilo ou legitimidade das operações e serviços prestados relacionados a administradora de consórcio;7;2;0;9;
2023;2º;40011095;XS5 ADMINISTRADORA DE CONSÓRCIOS S.A.;Não fornecimento, remessa ou divulgação de documentos por parte de administradora de consórcio;1;0;0;1;
2023;2º;40011095;XS5 ADMINISTRADORA DE CONSÓRCIOS S.A.;Oferta ou prestação de informação a respeito de produtos e serviços de forma inadequada por administradora de consórcio;5;0;0;5;
2023;2º;47458153;YAMAHA ADMINISTRADORA DE CONSÓRCIO LTDA.;Descumprimento de cláusulas referentes à devolução de valores;1;1;0;2;
2023;2º;47458153;YAMAHA ADMINISTRADORA DE CONSÓRCIO LTDA.;Descumprimento de obrigações previstas em contratos;0;1;0;1;
2023;2º;47458153;YAMAHA ADMINISTRADORA DE CONSÓRCIO LTDA.;Irregularidades relacionadas à liberação do crédito;1;4;0;5;
2023;2º;47458153;YAMAHA ADMINISTRADORA DE CONSÓRCIO LTDA.;Irregularidades relativas a integridade, confiabilidade, segurança, sigilo ou legitimidade das operações e serviços prestados relacionados a administradora de consórcio;3;3;0;6;
2023;2º;23367634;ZEMA ADMINISTRADORA DE CONSÓRCIO LTDA;Descumprimento de cláusulas referentes à devolução de valores;1;2;0;3;
2023;2º;23367634;ZEMA ADMINISTRADORA DE CONSÓRCIO LTDA;Descumprimento de prazo de resposta a demanda;0;1;0;1;
2023;2º;23367634;ZEMA ADMINISTRADORA DE CONSÓRCIO LTDA;Falta de transparência na redação de documentos por parte de administradora de consórcio;1;0;0;1;
2023;2º;23367634;ZEMA ADMINISTRADORA DE CONSÓRCIO LTDA;Insatisfação com a resposta fornecida pela administradora de consórcio relativa à demanda registrada contra ela;0;3;0;3;
2023;2º;23367634;ZEMA ADMINISTRADORA DE CONSÓRCIO LTDA;Insatisfação por parte do cliente com o atendimento prestado pela administradora de consórcio;0;0;2;2;
2023;2º;23367634;ZEMA ADMINISTRADORA DE CONSÓRCIO LTDA;Irregularidades relativas a integridade, confiabilidade, segurança, sigilo ou legitimidade das operações e serviços prestados relacionados a administradora de consórcio;0;1;0;1;
2023;2º;23367634;ZEMA ADMINISTRADORA DE CONSÓRCIO LTDA;Oferta ou prestação de informação a respeito de produtos e serviços de forma inadequada por administradora de consórcio;12;4;0;16;
