Ano;Semestre;CNPJ AC;Administradora de consórcio;Irregularidade;Quantidade de reclamações reguladas procedentes;Quantidade de reclamações reguladas - outras;Quantidade de reclamações não reguladas;Quantidade total de reclamações;
2015;1º;84911098;ADEMILAR ADMINISTRADORA DE CONSORCIOS S A;Descumprimento de prazo de resposta a demanda;1;0;0;1;
2015;1º;06044551;ADMINISTRADORA DE CONSORCIO NACIONAL GAZIN LTDA;Insatisfação por parte do cliente com o atendimento prestado pela administradora de consórcio;0;0;1;1;
2015;1º;45441789;ADMINISTRADORA DE CONSORCIO NACIONAL HONDA LTDA;Ausência de transparência nas relações contratuais;0;0;7;7;
2015;1º;45441789;ADMINISTRADORA DE CONSORCIO NACIONAL HONDA LTDA;Descumprimento de cláusulas referentes à devolução de valores;1;15;0;16;
2015;1º;45441789;ADMINISTRADORA DE CONSORCIO NACIONAL HONDA LTDA;Descumprimento de obrigações previstas em contratos;1;4;0;5;
2015;1º;45441789;ADMINISTRADORA DE CONSORCIO NACIONAL HONDA LTDA;Descumprimento de prazo de resposta a demanda;1;1;0;2;
2015;1º;45441789;ADMINISTRADORA DE CONSORCIO NACIONAL HONDA LTDA;Descumprimento de prazo para apresentação de resposta conclusiva pela Ouvidoria;0;1;0;1;
2015;1º;45441789;ADMINISTRADORA DE CONSORCIO NACIONAL HONDA LTDA;Insatisfação com a resposta fornecida pela administradora de consórcio, a demanda registrada contra ela;0;3;0;3;
2015;1º;45441789;ADMINISTRADORA DE CONSORCIO NACIONAL HONDA LTDA;Insatisfação por parte do cliente com o atendimento prestado pela administradora de consórcio;0;0;7;7;
2015;1º;45441789;ADMINISTRADORA DE CONSORCIO NACIONAL HONDA LTDA;Irregularidades relacionadas à liberação do crédito;3;46;0;49;
2015;1º;45441789;ADMINISTRADORA DE CONSORCIO NACIONAL HONDA LTDA;Irregularidades relacionadas às condições para contemplação por lance ou sorteio;0;4;0;4;
2015;1º;45441789;ADMINISTRADORA DE CONSORCIO NACIONAL HONDA LTDA;Outras irregularidades;1;3;0;4;
2015;1º;45441789;ADMINISTRADORA DE CONSORCIO NACIONAL HONDA LTDA;Prestação inadequada/insuficiente de informação;0;0;11;11;
2015;1º;45441789;ADMINISTRADORA DE CONSORCIO NACIONAL HONDA LTDA;Publicidade enganosa;0;0;1;1;
2015;1º;45441789;ADMINISTRADORA DE CONSORCIO NACIONAL HONDA LTDA;Reclamações relacionadas a assuntos diversos;0;0;21;21;
2015;1º;45441789;ADMINISTRADORA DE CONSORCIO NACIONAL HONDA LTDA;Recusa ou demora no fornecimento de documentos (exceto demonstrativos obrigatórios);0;0;6;6;
2015;1º;73230674;ADMINISTRADORA DE CONSORCIO RCI BRASIL LTDA;Ausência de transparência nas relações contratuais;0;0;1;1;
2015;1º;73230674;ADMINISTRADORA DE CONSORCIO RCI BRASIL LTDA;Descumprimento de cláusulas referentes à devolução de valores;0;3;0;3;
2015;1º;73230674;ADMINISTRADORA DE CONSORCIO RCI BRASIL LTDA;Descumprimento de obrigações previstas em contratos;0;1;0;1;
2015;1º;73230674;ADMINISTRADORA DE CONSORCIO RCI BRASIL LTDA;Insatisfação com a resposta fornecida pela administradora de consórcio, a demanda registrada contra ela;0;1;0;1;
2015;1º;73230674;ADMINISTRADORA DE CONSORCIO RCI BRASIL LTDA;Irregularidades relacionadas à liberação do crédito;0;3;0;3;
2015;1º;73230674;ADMINISTRADORA DE CONSORCIO RCI BRASIL LTDA;Prestação inadequada/insuficiente de informação;0;0;1;1;
2015;1º;73230674;ADMINISTRADORA DE CONSORCIO RCI BRASIL LTDA;Reclamações relacionadas a assuntos diversos;0;0;1;1;
2015;1º;03765340;ADMINISTRADORA DE CONSORCIO REGIONAL WAY LTDA;Reclamações relacionadas a assuntos diversos;0;0;1;1;
2015;1º;12228808;ADMINISTRADORA DE CONSORCIO SICOOB PARANA LTDA;Irregularidades relacionadas às condições para contemplação por lance ou sorteio;0;1;0;1;
2015;1º;12228808;ADMINISTRADORA DE CONSORCIO SICOOB PARANA LTDA;Prestação inadequada/insuficiente de informação;0;0;1;1;
2015;1º;12228808;ADMINISTRADORA DE CONSORCIO SICOOB PARANA LTDA;Recusa ou demora no fornecimento de documentos (exceto demonstrativos obrigatórios);0;0;1;1;
2015;1º;91341925;ADMINISTRADORA DE CONSORCIO SPENGLER LTDA;Descumprimento de cláusulas referentes à devolução de valores;0;1;0;1;
2015;1º;91341925;ADMINISTRADORA DE CONSORCIO SPENGLER LTDA;Descumprimento de obrigações previstas em contratos;0;1;0;1;
2015;1º;91341925;ADMINISTRADORA DE CONSORCIO SPENGLER LTDA;Insatisfação por parte do cliente com o atendimento prestado pela administradora de consórcio;0;0;1;1;
2015;1º;91341925;ADMINISTRADORA DE CONSORCIO SPENGLER LTDA;Prestação inadequada/insuficiente de informação;0;0;1;1;
2015;1º;03828278;ADMINISTRADORA DE CONSORCIOS BECKER LTDA;Insatisfação por parte do cliente com o atendimento prestado pela administradora de consórcio;0;0;1;1;
2015;1º;03828278;ADMINISTRADORA DE CONSORCIOS BECKER LTDA;Recusa ou demora no fornecimento de documentos (exceto demonstrativos obrigatórios);0;0;1;1;
2015;1º;07808907;ADMINISTRADORA DE CONSORCIOS SICREDI LTDA;Descumprimento de obrigações previstas em contratos;0;1;0;1;
2015;1º;07808907;ADMINISTRADORA DE CONSORCIOS SICREDI LTDA;Irregularidades relacionadas à liberação do crédito;0;1;0;1;
2015;1º;07808907;ADMINISTRADORA DE CONSORCIOS SICREDI LTDA;Prestação inadequada/insuficiente de informação;0;0;1;1;
2015;1º;94187879;AGIPLAN ADMINISTRADORA DE CONSORCIOS S A;Ausência de transparência nas relações contratuais;0;0;1;1;
2015;1º;69273308;AGRABEN ADMINISTRADORA DE CONSORCIOS LTDA;Descumprimento de cláusulas referentes à devolução de valores;0;1;0;1;
2015;1º;69273308;AGRABEN ADMINISTRADORA DE CONSORCIOS LTDA;Irregularidades relacionadas à liberação do crédito;1;0;0;1;
2015;1º;69273308;AGRABEN ADMINISTRADORA DE CONSORCIOS LTDA;Publicidade enganosa;0;0;1;1;
2015;1º;60375243;ANCORA ADMINISTRADORA DE CONSORCIOS S A;Descumprimento de cláusulas referentes à devolução de valores;0;2;0;2;
2015;1º;60375243;ANCORA ADMINISTRADORA DE CONSORCIOS S A;Irregularidades relacionadas à liberação do crédito;0;1;0;1;
2015;1º;02010478;BANCORBRAS ADMINISTRADORA DE CONSORCIOS LTDA;Prestação inadequada/insuficiente de informação;0;0;1;1;
2015;1º;02010478;BANCORBRAS ADMINISTRADORA DE CONSORCIOS LTDA;Publicidade enganosa;0;0;1;1;
2015;1º;02010478;BANCORBRAS ADMINISTRADORA DE CONSORCIOS LTDA;Reclamações relacionadas a assuntos diversos;0;0;2;2;
2015;1º;92692979;BANRISUL S A    ADMINISTRADORA DE CONSORCIOS;Descumprimento de obrigações previstas em contratos;0;2;0;2;
2015;1º;92692979;BANRISUL S A    ADMINISTRADORA DE CONSORCIOS;Insatisfação com a resposta fornecida pela administradora de consórcio, a demanda registrada contra ela;1;0;0;1;
2015;1º;92692979;BANRISUL S A    ADMINISTRADORA DE CONSORCIOS;Reclamações relacionadas a assuntos diversos;0;0;1;1;
2015;1º;92692979;BANRISUL S A    ADMINISTRADORA DE CONSORCIOS;Recusa ou demora no fornecimento de documentos (exceto demonstrativos obrigatórios);0;0;1;1;
2015;1º;06043050;BB ADMINISTRADORA DE CONSORCIOS S A;Ausência de transparência nas relações contratuais;0;0;11;11;
2015;1º;06043050;BB ADMINISTRADORA DE CONSORCIOS S A;Cobrança irregular de tarifa pela emissão de boletos, carnês e assemelhados;0;2;0;2;
2015;1º;06043050;BB ADMINISTRADORA DE CONSORCIOS S A;Descumprimento de cláusulas referentes à devolução de valores;0;8;0;8;
2015;1º;06043050;BB ADMINISTRADORA DE CONSORCIOS S A;Descumprimento de obrigações previstas em contratos;2;4;0;6;
2015;1º;06043050;BB ADMINISTRADORA DE CONSORCIOS S A;Descumprimento de prazo de resposta a demanda;1;0;0;1;
2015;1º;06043050;BB ADMINISTRADORA DE CONSORCIOS S A;Insatisfação com a resposta fornecida pela administradora de consórcio, a demanda registrada contra ela;0;4;0;4;
2015;1º;06043050;BB ADMINISTRADORA DE CONSORCIOS S A;Insatisfação por parte do cliente com o atendimento prestado pela administradora de consórcio;0;0;11;11;
2015;1º;06043050;BB ADMINISTRADORA DE CONSORCIOS S A;Irregularidades relacionadas à liberação do crédito;2;22;0;24;
2015;1º;06043050;BB ADMINISTRADORA DE CONSORCIOS S A;Irregularidades relacionadas às condições para contemplação por lance ou sorteio;0;1;0;1;
2015;1º;06043050;BB ADMINISTRADORA DE CONSORCIOS S A;Prestação inadequada/insuficiente de informação;0;0;28;28;
2015;1º;06043050;BB ADMINISTRADORA DE CONSORCIOS S A;Publicidade enganosa;0;0;1;1;
2015;1º;06043050;BB ADMINISTRADORA DE CONSORCIOS S A;Reclamações relacionadas a assuntos diversos;0;0;14;14;
2015;1º;06043050;BB ADMINISTRADORA DE CONSORCIOS S A;Recusa ou demora no fornecimento de documentos (exceto demonstrativos obrigatórios);0;0;1;1;
2015;1º;14723388;BR CONSORCIOS ADMINISTRADORA DE CONSORCIOS LTDA;Ausência de transparência nas relações contratuais;0;0;6;6;
2015;1º;14723388;BR CONSORCIOS ADMINISTRADORA DE CONSORCIOS LTDA;Descumprimento de cláusulas referentes à devolução de valores;0;4;0;4;
2015;1º;14723388;BR CONSORCIOS ADMINISTRADORA DE CONSORCIOS LTDA;Descumprimento de obrigações previstas em contratos;0;2;0;2;
2015;1º;14723388;BR CONSORCIOS ADMINISTRADORA DE CONSORCIOS LTDA;Descumprimento de prazo de resposta a demanda;1;0;0;1;
2015;1º;14723388;BR CONSORCIOS ADMINISTRADORA DE CONSORCIOS LTDA;Insatisfação com a resposta fornecida pela administradora de consórcio, a demanda registrada contra ela;0;1;0;1;
2015;1º;14723388;BR CONSORCIOS ADMINISTRADORA DE CONSORCIOS LTDA;Insatisfação por parte do cliente com o atendimento prestado pela administradora de consórcio;0;0;4;4;
2015;1º;14723388;BR CONSORCIOS ADMINISTRADORA DE CONSORCIOS LTDA;Irregularidades relacionadas à liberação do crédito;0;1;0;1;
2015;1º;14723388;BR CONSORCIOS ADMINISTRADORA DE CONSORCIOS LTDA;Irregularidades relacionadas às condições para contemplação por lance ou sorteio;0;2;0;2;
2015;1º;14723388;BR CONSORCIOS ADMINISTRADORA DE CONSORCIOS LTDA;Prestação inadequada/insuficiente de informação;0;0;3;3;
2015;1º;14723388;BR CONSORCIOS ADMINISTRADORA DE CONSORCIOS LTDA;Reclamações relacionadas a assuntos diversos;0;0;1;1;
2015;1º;14723388;BR CONSORCIOS ADMINISTRADORA DE CONSORCIOS LTDA;Recusa ou demora no fornecimento de documentos (exceto demonstrativos obrigatórios);0;0;2;2;
2015;1º;52568821;BRADESCO ADMINISTRADORA DE CONSORCIOS LTDA;Ausência de transparência nas relações contratuais;0;0;29;29;
2015;1º;52568821;BRADESCO ADMINISTRADORA DE CONSORCIOS LTDA;Descumprimento de cláusulas referentes à devolução de valores;0;20;0;20;
2015;1º;52568821;BRADESCO ADMINISTRADORA DE CONSORCIOS LTDA;Descumprimento de obrigações previstas em contratos;0;37;0;37;
2015;1º;52568821;BRADESCO ADMINISTRADORA DE CONSORCIOS LTDA;Descumprimento de prazo de resposta a demanda;1;5;0;6;
2015;1º;52568821;BRADESCO ADMINISTRADORA DE CONSORCIOS LTDA;Descumprimento de prazo para apresentação de resposta conclusiva pela Ouvidoria;0;2;0;2;
2015;1º;52568821;BRADESCO ADMINISTRADORA DE CONSORCIOS LTDA;Insatisfação com a resposta fornecida pela administradora de consórcio, a demanda registrada contra ela;1;12;0;13;
2015;1º;52568821;BRADESCO ADMINISTRADORA DE CONSORCIOS LTDA;Insatisfação por parte do cliente com o atendimento prestado pela administradora de consórcio;0;0;45;45;
2015;1º;52568821;BRADESCO ADMINISTRADORA DE CONSORCIOS LTDA;Irregularidades relacionadas à liberação do crédito;2;66;0;68;
2015;1º;52568821;BRADESCO ADMINISTRADORA DE CONSORCIOS LTDA;Irregularidades relacionadas às condições para contemplação por lance ou sorteio;0;3;0;3;
2015;1º;52568821;BRADESCO ADMINISTRADORA DE CONSORCIOS LTDA;Outras irregularidades;1;5;0;6;
2015;1º;52568821;BRADESCO ADMINISTRADORA DE CONSORCIOS LTDA;Prestação inadequada/insuficiente de informação;0;0;59;59;
2015;1º;52568821;BRADESCO ADMINISTRADORA DE CONSORCIOS LTDA;Publicidade enganosa;0;0;5;5;
2015;1º;52568821;BRADESCO ADMINISTRADORA DE CONSORCIOS LTDA;Reclamações relacionadas a assuntos diversos;0;0;60;60;
2015;1º;52568821;BRADESCO ADMINISTRADORA DE CONSORCIOS LTDA;Recusa ou demora no fornecimento de documentos (exceto demonstrativos obrigatórios);0;0;34;34;
2015;1º;45713971;BRQUALY ADMINISTRADORA DE CONSORCIOS LTDA;Descumprimento de cláusulas referentes à devolução de valores;0;3;0;3;
2015;1º;05349595;CAIXA CONSORCIOS S A ADMINISTRADORA DE CONSORCIOS;Ausência de informações/cláusulas obrigatórias em contrato;1;0;0;1;
2015;1º;05349595;CAIXA CONSORCIOS S A ADMINISTRADORA DE CONSORCIOS;Ausência de transparência nas relações contratuais;0;0;5;5;
2015;1º;05349595;CAIXA CONSORCIOS S A ADMINISTRADORA DE CONSORCIOS;Cobrança irregular de tarifa pela emissão de boletos, carnês e assemelhados;0;1;0;1;
2015;1º;05349595;CAIXA CONSORCIOS S A ADMINISTRADORA DE CONSORCIOS;Descumprimento de cláusulas referentes à devolução de valores;4;22;0;26;
2015;1º;05349595;CAIXA CONSORCIOS S A ADMINISTRADORA DE CONSORCIOS;Descumprimento de obrigações previstas em contratos;5;17;0;22;
2015;1º;05349595;CAIXA CONSORCIOS S A ADMINISTRADORA DE CONSORCIOS;Descumprimento de prazo de resposta a demanda;0;1;0;1;
2015;1º;05349595;CAIXA CONSORCIOS S A ADMINISTRADORA DE CONSORCIOS;Descumprimento de prazo para apresentação de resposta conclusiva pela Ouvidoria;0;1;0;1;
2015;1º;05349595;CAIXA CONSORCIOS S A ADMINISTRADORA DE CONSORCIOS;Insatisfação com a resposta fornecida pela administradora de consórcio, a demanda registrada contra ela;8;18;0;26;
2015;1º;05349595;CAIXA CONSORCIOS S A ADMINISTRADORA DE CONSORCIOS;Insatisfação por parte do cliente com o atendimento prestado pela administradora de consórcio;0;0;98;98;
2015;1º;05349595;CAIXA CONSORCIOS S A ADMINISTRADORA DE CONSORCIOS;Irregularidades relacionadas à liberação do crédito;9;114;0;123;
2015;1º;05349595;CAIXA CONSORCIOS S A ADMINISTRADORA DE CONSORCIOS;Irregularidades relacionadas às condições para contemplação por lance ou sorteio;1;5;0;6;
2015;1º;05349595;CAIXA CONSORCIOS S A ADMINISTRADORA DE CONSORCIOS;Não fornecimento, remessa ou divulgação de documentos obrigatórios;0;1;0;1;
2015;1º;05349595;CAIXA CONSORCIOS S A ADMINISTRADORA DE CONSORCIOS;Outras irregularidades;0;2;0;2;
2015;1º;05349595;CAIXA CONSORCIOS S A ADMINISTRADORA DE CONSORCIOS;Outras irregularidades relacionadas à Ouvidoria;0;1;0;1;
2015;1º;05349595;CAIXA CONSORCIOS S A ADMINISTRADORA DE CONSORCIOS;Prestação inadequada/insuficiente de informação;0;0;26;26;
2015;1º;05349595;CAIXA CONSORCIOS S A ADMINISTRADORA DE CONSORCIOS;Publicidade enganosa;0;0;3;3;
2015;1º;05349595;CAIXA CONSORCIOS S A ADMINISTRADORA DE CONSORCIOS;Reclamações relacionadas a assuntos diversos;0;0;48;48;
2015;1º;05349595;CAIXA CONSORCIOS S A ADMINISTRADORA DE CONSORCIOS;Recusa ou demora no fornecimento de documentos (exceto demonstrativos obrigatórios);0;0;22;22;
2015;1º;68318773;CANOPUS ADMINISTRADORA DE CONSORCIOS S A;Irregularidades relacionadas às condições para contemplação por lance ou sorteio;0;1;0;1;
2015;1º;68318773;CANOPUS ADMINISTRADORA DE CONSORCIOS S A;Publicidade enganosa;0;0;2;2;
2015;1º;95783262;CARLESSI ADMINISTRADORA DE CONSORCIOS LTDA;Descumprimento de cláusulas referentes à devolução de valores;0;1;0;1;
2015;1º;00266031;CICAL ADMINISTRADORA DE CONSORCIOS LTDA;Reclamações relacionadas a assuntos diversos;0;0;1;1;
2015;1º;59129403;CNF   ADMINISTRADORA DE CONSORCIOS NACIONAL LTDA;Ausência de transparência nas relações contratuais;0;0;5;5;
2015;1º;59129403;CNF   ADMINISTRADORA DE CONSORCIOS NACIONAL LTDA;Cobrança irregular de tarifa pela emissão de boletos, carnês e assemelhados;0;1;0;1;
2015;1º;59129403;CNF   ADMINISTRADORA DE CONSORCIOS NACIONAL LTDA;Descumprimento de cláusulas referentes à devolução de valores;0;2;0;2;
2015;1º;59129403;CNF   ADMINISTRADORA DE CONSORCIOS NACIONAL LTDA;Insatisfação com a resposta fornecida pela administradora de consórcio, a demanda registrada contra ela;1;3;0;4;
2015;1º;59129403;CNF   ADMINISTRADORA DE CONSORCIOS NACIONAL LTDA;Insatisfação por parte do cliente com o atendimento prestado pela administradora de consórcio;0;0;2;2;
2015;1º;59129403;CNF   ADMINISTRADORA DE CONSORCIOS NACIONAL LTDA;Irregularidades relacionadas à liberação do crédito;0;2;0;2;
2015;1º;59129403;CNF   ADMINISTRADORA DE CONSORCIOS NACIONAL LTDA;Prestação inadequada/insuficiente de informação;0;0;2;2;
2015;1º;59129403;CNF   ADMINISTRADORA DE CONSORCIOS NACIONAL LTDA;Reclamações relacionadas a assuntos diversos;0;0;2;2;
2015;1º;59129403;CNF   ADMINISTRADORA DE CONSORCIOS NACIONAL LTDA;Recusa ou demora no fornecimento de documentos (exceto demonstrativos obrigatórios);0;0;2;2;
2015;1º;62798475;CNK ADMINISTRADORA DE CONSORCIO LTDA;Insatisfação por parte do cliente com o atendimento prestado pela administradora de consórcio;0;0;1;1;
2015;1º;62798475;CNK ADMINISTRADORA DE CONSORCIO LTDA;Reclamações relacionadas a assuntos diversos;0;0;1;1;
2015;1º;62798475;CNK ADMINISTRADORA DE CONSORCIO LTDA;Recusa ou demora no fornecimento de documentos (exceto demonstrativos obrigatórios);0;0;1;1;
2015;1º;27268770;COIMEX ADMINISTRADORA DE CONSORCIOS LTDA;Irregularidades relacionadas à liberação do crédito;0;1;0;1;
2015;1º;75770164;CONBR ADMINISTRADORA DE CONSORCIOS LTDA;Não fornecimento, remessa ou divulgação de documentos obrigatórios;0;1;0;1;
2015;1º;07336852;CONBRAV   ADMINISTRADORA DE CONSORCIOS LTDA;Ausência de transparência nas relações contratuais;0;0;1;1;
2015;1º;07336852;CONBRAV   ADMINISTRADORA DE CONSORCIOS LTDA;Descumprimento de obrigações previstas em contratos;0;1;0;1;
2015;1º;07336852;CONBRAV   ADMINISTRADORA DE CONSORCIOS LTDA;Insatisfação por parte do cliente com o atendimento prestado pela administradora de consórcio;0;0;1;1;
2015;1º;81742223;CONSEG ADMINISTRADORA DE CONSORCIOS LTDA;Descumprimento de prazo de resposta a demanda;0;1;0;1;
2015;1º;81742223;CONSEG ADMINISTRADORA DE CONSORCIOS LTDA;Irregularidades relacionadas às condições para contemplação por lance ou sorteio;0;2;0;2;
2015;1º;81742223;CONSEG ADMINISTRADORA DE CONSORCIOS LTDA;Prestação inadequada/insuficiente de informação;0;0;1;1;
2015;1º;44196293;CONSHOP ADMINISTRADORA DE CONSORCIOS LTDA;Descumprimento de cláusulas referentes à devolução de valores;0;2;0;2;
2015;1º;44196293;CONSHOP ADMINISTRADORA DE CONSORCIOS LTDA;Descumprimento de prazo de resposta a demanda;0;1;0;1;
2015;1º;47658539;CONSORCIO NACIONAL VOLKSWAGEN   ADMINISTRADORA DE CONSORCIO LTDA;Ausência de transparência nas relações contratuais;0;0;39;39;
2015;1º;47658539;CONSORCIO NACIONAL VOLKSWAGEN   ADMINISTRADORA DE CONSORCIO LTDA;Cobrança irregular de tarifa pela emissão de boletos, carnês e assemelhados;0;1;0;1;
2015;1º;47658539;CONSORCIO NACIONAL VOLKSWAGEN   ADMINISTRADORA DE CONSORCIO LTDA;Descumprimento de cláusulas referentes à devolução de valores;0;16;0;16;
2015;1º;47658539;CONSORCIO NACIONAL VOLKSWAGEN   ADMINISTRADORA DE CONSORCIO LTDA;Descumprimento de obrigações previstas em contratos;0;4;0;4;
2015;1º;47658539;CONSORCIO NACIONAL VOLKSWAGEN   ADMINISTRADORA DE CONSORCIO LTDA;Descumprimento de prazo de resposta a demanda;0;4;0;4;
2015;1º;47658539;CONSORCIO NACIONAL VOLKSWAGEN   ADMINISTRADORA DE CONSORCIO LTDA;Descumprimento de prazo para apresentação de resposta conclusiva pela Ouvidoria;0;1;0;1;
2015;1º;47658539;CONSORCIO NACIONAL VOLKSWAGEN   ADMINISTRADORA DE CONSORCIO LTDA;Insatisfação com a resposta fornecida pela administradora de consórcio, a demanda registrada contra ela;1;4;0;5;
2015;1º;47658539;CONSORCIO NACIONAL VOLKSWAGEN   ADMINISTRADORA DE CONSORCIO LTDA;Insatisfação por parte do cliente com o atendimento prestado pela administradora de consórcio;0;0;73;73;
2015;1º;47658539;CONSORCIO NACIONAL VOLKSWAGEN   ADMINISTRADORA DE CONSORCIO LTDA;Irregularidades relacionadas à liberação do crédito;0;42;0;42;
2015;1º;47658539;CONSORCIO NACIONAL VOLKSWAGEN   ADMINISTRADORA DE CONSORCIO LTDA;Irregularidades relacionadas às condições para contemplação por lance ou sorteio;0;10;0;10;
2015;1º;47658539;CONSORCIO NACIONAL VOLKSWAGEN   ADMINISTRADORA DE CONSORCIO LTDA;Outras irregularidades;0;2;0;2;
2015;1º;47658539;CONSORCIO NACIONAL VOLKSWAGEN   ADMINISTRADORA DE CONSORCIO LTDA;Prestação inadequada/insuficiente de informação;0;0;19;19;
2015;1º;47658539;CONSORCIO NACIONAL VOLKSWAGEN   ADMINISTRADORA DE CONSORCIO LTDA;Publicidade enganosa;0;0;2;2;
2015;1º;47658539;CONSORCIO NACIONAL VOLKSWAGEN   ADMINISTRADORA DE CONSORCIO LTDA;Reclamações relacionadas a assuntos diversos;0;0;30;30;
2015;1º;47658539;CONSORCIO NACIONAL VOLKSWAGEN   ADMINISTRADORA DE CONSORCIO LTDA;Recusa ou demora no fornecimento de documentos (exceto demonstrativos obrigatórios);0;0;11;11;
2015;1º;27440684;CONTAUTO ADMINISTRADORA DE CONSORCIOS LTDA;Irregularidades relacionadas à liberação do crédito;0;1;0;1;
2015;1º;58919903;CONVEF ADMINISTRADORA DE CONSORCIOS LTDA;Descumprimento de prazo para apresentação de resposta conclusiva pela Ouvidoria;0;1;0;1;
2015;1º;58919903;CONVEF ADMINISTRADORA DE CONSORCIOS LTDA;Insatisfação por parte do cliente com o atendimento prestado pela administradora de consórcio;0;0;1;1;
2015;1º;58919903;CONVEF ADMINISTRADORA DE CONSORCIOS LTDA;Irregularidades relacionadas à liberação do crédito;0;3;0;3;
2015;1º;58919903;CONVEF ADMINISTRADORA DE CONSORCIOS LTDA;Irregularidades relacionadas às condições para contemplação por lance ou sorteio;0;1;0;1;
2015;1º;58919903;CONVEF ADMINISTRADORA DE CONSORCIOS LTDA;Prestação inadequada/insuficiente de informação;0;0;2;2;
2015;1º;58919903;CONVEF ADMINISTRADORA DE CONSORCIOS LTDA;Publicidade enganosa;0;0;1;1;
2015;1º;58919903;CONVEF ADMINISTRADORA DE CONSORCIOS LTDA;Reclamações relacionadas a assuntos diversos;0;0;1;1;
2015;1º;95790267;DIMAS ADMINISTRADORA DE CONSORCIOS LTDA;Prestação inadequada/insuficiente de informação;0;0;1;1;
2015;1º;59395061;DISAL ADMINISTRADORA DE CONSORCIOS LTDA;Ausência de transparência nas relações contratuais;0;0;10;10;
2015;1º;59395061;DISAL ADMINISTRADORA DE CONSORCIOS LTDA;Descumprimento de cláusulas referentes à devolução de valores;0;8;0;8;
2015;1º;59395061;DISAL ADMINISTRADORA DE CONSORCIOS LTDA;Descumprimento de obrigações previstas em contratos;1;6;0;7;
2015;1º;59395061;DISAL ADMINISTRADORA DE CONSORCIOS LTDA;Insatisfação por parte do cliente com o atendimento prestado pela administradora de consórcio;0;0;8;8;
2015;1º;59395061;DISAL ADMINISTRADORA DE CONSORCIOS LTDA;Irregularidades relacionadas à liberação do crédito;0;22;0;22;
2015;1º;59395061;DISAL ADMINISTRADORA DE CONSORCIOS LTDA;Irregularidades relacionadas às condições para contemplação por lance ou sorteio;0;2;0;2;
2015;1º;59395061;DISAL ADMINISTRADORA DE CONSORCIOS LTDA;Outras irregularidades relacionadas à Ouvidoria;0;3;0;3;
2015;1º;59395061;DISAL ADMINISTRADORA DE CONSORCIOS LTDA;Prestação inadequada/insuficiente de informação;0;0;22;22;
2015;1º;59395061;DISAL ADMINISTRADORA DE CONSORCIOS LTDA;Publicidade enganosa;0;0;3;3;
2015;1º;59395061;DISAL ADMINISTRADORA DE CONSORCIOS LTDA;Reclamações relacionadas a assuntos diversos;0;0;13;13;
2015;1º;59395061;DISAL ADMINISTRADORA DE CONSORCIOS LTDA;Recusa ou demora no fornecimento de documentos (exceto demonstrativos obrigatórios);0;0;4;4;
2015;1º;01659838;DISBRAVE ADMINISTRADORA DE CONSORCIOS LTDA;Prestação inadequada/insuficiente de informação;0;0;1;1;
2015;1º;58113812;EMBRACON ADMINISTRADORA DE CONSORCIO LTDA;Ausência de transparência nas relações contratuais;0;0;6;6;
2015;1º;58113812;EMBRACON ADMINISTRADORA DE CONSORCIO LTDA;Descumprimento de cláusulas referentes à devolução de valores;1;3;0;4;
2015;1º;58113812;EMBRACON ADMINISTRADORA DE CONSORCIO LTDA;Descumprimento de obrigações previstas em contratos;0;2;0;2;
2015;1º;58113812;EMBRACON ADMINISTRADORA DE CONSORCIO LTDA;Descumprimento de prazo de resposta a demanda;0;3;0;3;
2015;1º;58113812;EMBRACON ADMINISTRADORA DE CONSORCIO LTDA;Descumprimento de prazo para apresentação de resposta conclusiva pela Ouvidoria;0;2;0;2;
2015;1º;58113812;EMBRACON ADMINISTRADORA DE CONSORCIO LTDA;Insatisfação com a resposta fornecida pela administradora de consórcio, a demanda registrada contra ela;1;6;0;7;
2015;1º;58113812;EMBRACON ADMINISTRADORA DE CONSORCIO LTDA;Insatisfação por parte do cliente com o atendimento prestado pela administradora de consórcio;0;0;14;14;
2015;1º;58113812;EMBRACON ADMINISTRADORA DE CONSORCIO LTDA;Irregularidades relacionadas à liberação do crédito;0;31;0;31;
2015;1º;58113812;EMBRACON ADMINISTRADORA DE CONSORCIO LTDA;Não divulgação de acesso telefônico gratuito da Ouvidoria;0;1;0;1;
2015;1º;58113812;EMBRACON ADMINISTRADORA DE CONSORCIO LTDA;Outras irregularidades relacionadas à Ouvidoria;0;2;0;2;
2015;1º;58113812;EMBRACON ADMINISTRADORA DE CONSORCIO LTDA;Prestação inadequada/insuficiente de informação;0;0;43;43;
2015;1º;58113812;EMBRACON ADMINISTRADORA DE CONSORCIO LTDA;Publicidade enganosa;0;0;49;49;
2015;1º;58113812;EMBRACON ADMINISTRADORA DE CONSORCIO LTDA;Reclamações relacionadas a assuntos diversos;0;0;23;23;
2015;1º;58113812;EMBRACON ADMINISTRADORA DE CONSORCIO LTDA;Recusa ou demora no fornecimento de documentos (exceto demonstrativos obrigatórios);0;0;9;9;
2015;1º;91107581;FARROUPILHA ADMINISTRADORA DE CONSORCIOS LTDA;Descumprimento de cláusulas referentes à devolução de valores;0;3;0;3;
2015;1º;91107581;FARROUPILHA ADMINISTRADORA DE CONSORCIOS LTDA;Insatisfação por parte do cliente com o atendimento prestado pela administradora de consórcio;0;0;2;2;
2015;1º;04751943;FRANCAUTO ADMINISTRADORA DE CONSORCIO LTDA;Cobrança irregular de tarifa pela emissão de boletos, carnês e assemelhados;1;0;0;1;
2015;1º;85322204;GLOBO ADMINISTRADORA DE CONSORCIOS LTDA;Insatisfação por parte do cliente com o atendimento prestado pela administradora de consórcio;0;0;1;1;
2015;1º;49937055;GMAC ADMINISTRADORA DE CONSORCIOS LTDA;Ausência de informações/cláusulas obrigatórias em contrato;1;0;0;1;
2015;1º;49937055;GMAC ADMINISTRADORA DE CONSORCIOS LTDA;Ausência de transparência nas relações contratuais;0;0;9;9;
2015;1º;49937055;GMAC ADMINISTRADORA DE CONSORCIOS LTDA;Descumprimento de cláusulas referentes à devolução de valores;2;10;0;12;
2015;1º;49937055;GMAC ADMINISTRADORA DE CONSORCIOS LTDA;Descumprimento de obrigações previstas em contratos;1;5;0;6;
2015;1º;49937055;GMAC ADMINISTRADORA DE CONSORCIOS LTDA;Insatisfação com a resposta fornecida pela administradora de consórcio, a demanda registrada contra ela;1;5;0;6;
2015;1º;49937055;GMAC ADMINISTRADORA DE CONSORCIOS LTDA;Insatisfação por parte do cliente com o atendimento prestado pela administradora de consórcio;0;0;6;6;
2015;1º;49937055;GMAC ADMINISTRADORA DE CONSORCIOS LTDA;Irregularidades relacionadas à liberação do crédito;1;32;0;33;
2015;1º;49937055;GMAC ADMINISTRADORA DE CONSORCIOS LTDA;Irregularidades relacionadas às condições para contemplação por lance ou sorteio;1;4;0;5;
2015;1º;49937055;GMAC ADMINISTRADORA DE CONSORCIOS LTDA;Outras irregularidades;0;2;0;2;
2015;1º;49937055;GMAC ADMINISTRADORA DE CONSORCIOS LTDA;Outras irregularidades relacionadas à Ouvidoria;0;1;0;1;
2015;1º;49937055;GMAC ADMINISTRADORA DE CONSORCIOS LTDA;Prestação inadequada/insuficiente de informação;0;0;27;27;
2015;1º;49937055;GMAC ADMINISTRADORA DE CONSORCIOS LTDA;Publicidade enganosa;0;0;4;4;
2015;1º;49937055;GMAC ADMINISTRADORA DE CONSORCIOS LTDA;Reclamações relacionadas a assuntos diversos;0;0;18;18;
2015;1º;49937055;GMAC ADMINISTRADORA DE CONSORCIOS LTDA;Recusa ou demora no fornecimento de documentos (exceto demonstrativos obrigatórios);0;0;9;9;
2015;1º;02798858;GOVESA ADMINISTRADORA DE CONSORCIOS LTDA;Descumprimento de prazo de resposta a demanda;0;1;0;1;
2015;1º;02798858;GOVESA ADMINISTRADORA DE CONSORCIOS LTDA;Insatisfação por parte do cliente com o atendimento prestado pela administradora de consórcio;0;0;1;1;
2015;1º;02798858;GOVESA ADMINISTRADORA DE CONSORCIOS LTDA;Publicidade enganosa;0;0;1;1;
2015;1º;02798858;GOVESA ADMINISTRADORA DE CONSORCIOS LTDA;Recusa ou demora no fornecimento de documentos (exceto demonstrativos obrigatórios);0;0;1;1;
2015;1º;91338228;GRAVEL ADMINISTRADORA DE CONSORCIOS LTDA;Descumprimento de cláusulas referentes à devolução de valores;0;1;0;1;
2015;1º;91338228;GRAVEL ADMINISTRADORA DE CONSORCIOS LTDA;Prestação inadequada/insuficiente de informação;0;0;1;1;
2015;1º;26228270;GROSCON ADMINISTRADORA DE CONSORCIOS LTDA;Descumprimento de cláusulas referentes à devolução de valores;0;2;0;2;
2015;1º;03586655;H  ADMINISTRADORA DE CONSORCIOS LTDA;Descumprimento de cláusulas referentes à devolução de valores;0;1;0;1;
2015;1º;03586655;H  ADMINISTRADORA DE CONSORCIOS LTDA;Irregularidades relacionadas às condições para contemplação por lance ou sorteio;0;1;0;1;
2015;1º;03586655;H  ADMINISTRADORA DE CONSORCIOS LTDA;Prestação inadequada/insuficiente de informação;0;0;2;2;
2015;1º;03586655;H  ADMINISTRADORA DE CONSORCIOS LTDA;Publicidade enganosa;0;0;1;1;
2015;1º;03586655;H  ADMINISTRADORA DE CONSORCIOS LTDA;Reclamações relacionadas a assuntos diversos;0;0;1;1;
2015;1º;03586655;H  ADMINISTRADORA DE CONSORCIOS LTDA;Recusa ou demora no fornecimento de documentos (exceto demonstrativos obrigatórios);0;0;1;1;
2015;1º;73516106;HS ADMINISTRADORA DE CONSORCIOS LTDA;Prestação inadequada/insuficiente de informação;0;0;1;1;
2015;1º;60241809;HSBC  BRASIL  ADMINISTRADORA DE CONSORCIO LTDA;Ausência de transparência nas relações contratuais;0;0;3;3;
2015;1º;60241809;HSBC  BRASIL  ADMINISTRADORA DE CONSORCIO LTDA;Descumprimento de cláusulas referentes à devolução de valores;0;3;0;3;
2015;1º;60241809;HSBC  BRASIL  ADMINISTRADORA DE CONSORCIO LTDA;Descumprimento de obrigações previstas em contratos;0;9;0;9;
2015;1º;60241809;HSBC  BRASIL  ADMINISTRADORA DE CONSORCIO LTDA;Descumprimento de prazo de resposta a demanda;0;1;0;1;
2015;1º;60241809;HSBC  BRASIL  ADMINISTRADORA DE CONSORCIO LTDA;Insatisfação com a resposta fornecida pela administradora de consórcio, a demanda registrada contra ela;0;4;0;4;
2015;1º;60241809;HSBC  BRASIL  ADMINISTRADORA DE CONSORCIO LTDA;Insatisfação por parte do cliente com o atendimento prestado pela administradora de consórcio;0;0;6;6;
2015;1º;60241809;HSBC  BRASIL  ADMINISTRADORA DE CONSORCIO LTDA;Irregularidades relacionadas à liberação do crédito;0;4;0;4;
2015;1º;60241809;HSBC  BRASIL  ADMINISTRADORA DE CONSORCIO LTDA;Outras irregularidades;0;2;0;2;
2015;1º;60241809;HSBC  BRASIL  ADMINISTRADORA DE CONSORCIO LTDA;Prestação inadequada/insuficiente de informação;0;0;3;3;
2015;1º;60241809;HSBC  BRASIL  ADMINISTRADORA DE CONSORCIO LTDA;Reclamações relacionadas a assuntos diversos;0;0;6;6;
2015;1º;60241809;HSBC  BRASIL  ADMINISTRADORA DE CONSORCIO LTDA;Recusa ou demora no fornecimento de documentos (exceto demonstrativos obrigatórios);0;0;6;6;
2015;1º;46006482;IDEROL ADMINISTRADORA DE CONSORCIO LTDA;Reclamações relacionadas a assuntos diversos;0;0;1;1;
2015;1º;07970374;ITABENS ADMINISTRADORA DE CONSORCIOS LTDA;Prestação inadequada/insuficiente de informação;0;0;1;1;
2015;1º;00000776;ITAU ADMINISTRADORA DE CONSORCIOS LTDA;Ausência de transparência nas relações contratuais;0;0;18;18;
2015;1º;00000776;ITAU ADMINISTRADORA DE CONSORCIOS LTDA;Cobrança irregular de tarifa pela emissão de boletos, carnês e assemelhados;0;2;0;2;
2015;1º;00000776;ITAU ADMINISTRADORA DE CONSORCIOS LTDA;Descumprimento de cláusulas referentes à devolução de valores;3;32;0;35;
2015;1º;00000776;ITAU ADMINISTRADORA DE CONSORCIOS LTDA;Descumprimento de obrigações previstas em contratos;29;77;0;106;
2015;1º;00000776;ITAU ADMINISTRADORA DE CONSORCIOS LTDA;Descumprimento de prazo de resposta a demanda;0;4;0;4;
2015;1º;00000776;ITAU ADMINISTRADORA DE CONSORCIOS LTDA;Descumprimento de prazo para apresentação de resposta conclusiva pela Ouvidoria;0;1;0;1;
2015;1º;00000776;ITAU ADMINISTRADORA DE CONSORCIOS LTDA;Insatisfação com a resposta fornecida pela administradora de consórcio, a demanda registrada contra ela;3;38;0;41;
2015;1º;00000776;ITAU ADMINISTRADORA DE CONSORCIOS LTDA;Insatisfação por parte do cliente com o atendimento prestado pela administradora de consórcio;0;0;75;75;
2015;1º;00000776;ITAU ADMINISTRADORA DE CONSORCIOS LTDA;Irregularidades relacionadas à liberação do crédito;0;199;0;199;
2015;1º;00000776;ITAU ADMINISTRADORA DE CONSORCIOS LTDA;Irregularidades relacionadas às condições para contemplação por lance ou sorteio;0;16;0;16;
2015;1º;00000776;ITAU ADMINISTRADORA DE CONSORCIOS LTDA;Não disponibilização de acesso telefônico gratuito à Ouvidoria;0;1;0;1;
2015;1º;00000776;ITAU ADMINISTRADORA DE CONSORCIOS LTDA;Não fornecimento, remessa ou divulgação de documentos obrigatórios;0;4;0;4;
2015;1º;00000776;ITAU ADMINISTRADORA DE CONSORCIOS LTDA;Outras irregularidades;0;1;0;1;
2015;1º;00000776;ITAU ADMINISTRADORA DE CONSORCIOS LTDA;Outras irregularidades relacionadas à Ouvidoria;0;1;0;1;
2015;1º;00000776;ITAU ADMINISTRADORA DE CONSORCIOS LTDA;Prestação inadequada/insuficiente de informação;0;0;110;110;
2015;1º;00000776;ITAU ADMINISTRADORA DE CONSORCIOS LTDA;Publicidade enganosa;0;0;9;9;
2015;1º;00000776;ITAU ADMINISTRADORA DE CONSORCIOS LTDA;Reclamações relacionadas a assuntos diversos;0;0;96;96;
2015;1º;00000776;ITAU ADMINISTRADORA DE CONSORCIOS LTDA;Recusa ou demora no fornecimento de documentos (exceto demonstrativos obrigatórios);0;0;44;44;
2015;1º;42421776;ITAU UNIBANCO VEICULOS ADMINISTRADORA DE CONSORCIOS LTDA;Ausência de transparência nas relações contratuais;0;0;1;1;
2015;1º;42421776;ITAU UNIBANCO VEICULOS ADMINISTRADORA DE CONSORCIOS LTDA;Cobrança irregular de tarifa pela emissão de boletos, carnês e assemelhados;0;2;0;2;
2015;1º;42421776;ITAU UNIBANCO VEICULOS ADMINISTRADORA DE CONSORCIOS LTDA;Descumprimento de cláusulas referentes à devolução de valores;0;7;0;7;
2015;1º;42421776;ITAU UNIBANCO VEICULOS ADMINISTRADORA DE CONSORCIOS LTDA;Descumprimento de obrigações previstas em contratos;9;14;0;23;
2015;1º;42421776;ITAU UNIBANCO VEICULOS ADMINISTRADORA DE CONSORCIOS LTDA;Descumprimento de prazo de resposta a demanda;1;1;0;2;
2015;1º;42421776;ITAU UNIBANCO VEICULOS ADMINISTRADORA DE CONSORCIOS LTDA;Insatisfação com a resposta fornecida pela administradora de consórcio, a demanda registrada contra ela;1;6;0;7;
2015;1º;42421776;ITAU UNIBANCO VEICULOS ADMINISTRADORA DE CONSORCIOS LTDA;Insatisfação por parte do cliente com o atendimento prestado pela administradora de consórcio;0;0;17;17;
2015;1º;42421776;ITAU UNIBANCO VEICULOS ADMINISTRADORA DE CONSORCIOS LTDA;Irregularidades relacionadas à liberação do crédito;1;38;0;39;
2015;1º;42421776;ITAU UNIBANCO VEICULOS ADMINISTRADORA DE CONSORCIOS LTDA;Irregularidades relacionadas às condições para contemplação por lance ou sorteio;0;2;0;2;
2015;1º;42421776;ITAU UNIBANCO VEICULOS ADMINISTRADORA DE CONSORCIOS LTDA;Outras irregularidades;0;1;0;1;
2015;1º;42421776;ITAU UNIBANCO VEICULOS ADMINISTRADORA DE CONSORCIOS LTDA;Prestação inadequada/insuficiente de informação;0;0;27;27;
2015;1º;42421776;ITAU UNIBANCO VEICULOS ADMINISTRADORA DE CONSORCIOS LTDA;Publicidade enganosa;0;0;1;1;
2015;1º;42421776;ITAU UNIBANCO VEICULOS ADMINISTRADORA DE CONSORCIOS LTDA;Reclamações relacionadas a assuntos diversos;0;0;19;19;
2015;1º;42421776;ITAU UNIBANCO VEICULOS ADMINISTRADORA DE CONSORCIOS LTDA;Recusa ou demora no fornecimento de documentos (exceto demonstrativos obrigatórios);0;0;8;8;
2015;1º;06181431;ITAUNA ADMINISTRADORA DE CONSORCIO LTDA;Prestação inadequada/insuficiente de informação;0;0;2;2;
2015;1º;06181431;ITAUNA ADMINISTRADORA DE CONSORCIO LTDA;Reclamações relacionadas a assuntos diversos;0;0;4;4;
2015;1º;37137767;JORLAN ADMINISTRADORA DE CONSORCIO LTDA;Prestação inadequada/insuficiente de informação;0;0;1;1;
2015;1º;60250776;LUIZA ADMINISTRADORA DE CONSORCIOS LTDA;Ausência de transparência nas relações contratuais;0;0;2;2;
2015;1º;60250776;LUIZA ADMINISTRADORA DE CONSORCIOS LTDA;Descumprimento de cláusulas referentes à devolução de valores;0;1;0;1;
2015;1º;60250776;LUIZA ADMINISTRADORA DE CONSORCIOS LTDA;Insatisfação por parte do cliente com o atendimento prestado pela administradora de consórcio;0;0;1;1;
2015;1º;60250776;LUIZA ADMINISTRADORA DE CONSORCIOS LTDA;Irregularidades relacionadas à liberação do crédito;0;1;0;1;
2015;1º;60250776;LUIZA ADMINISTRADORA DE CONSORCIOS LTDA;Outras irregularidades;0;1;0;1;
2015;1º;60250776;LUIZA ADMINISTRADORA DE CONSORCIOS LTDA;Prestação inadequada/insuficiente de informação;0;0;2;2;
2015;1º;60250776;LUIZA ADMINISTRADORA DE CONSORCIOS LTDA;Reclamações relacionadas a assuntos diversos;0;0;2;2;
2015;1º;60250776;LUIZA ADMINISTRADORA DE CONSORCIOS LTDA;Recusa ou demora no fornecimento de documentos (exceto demonstrativos obrigatórios);0;0;2;2;
2015;1º;04250224;MAGGI ADMINISTRADORA DE CONSORCIOS LTDA;Ausência de transparência nas relações contratuais;0;0;1;1;
2015;1º;04250224;MAGGI ADMINISTRADORA DE CONSORCIOS LTDA;Insatisfação por parte do cliente com o atendimento prestado pela administradora de consórcio;0;0;1;1;
2015;1º;04250224;MAGGI ADMINISTRADORA DE CONSORCIOS LTDA;Irregularidades relacionadas à liberação do crédito;0;2;0;2;
2015;1º;04250224;MAGGI ADMINISTRADORA DE CONSORCIOS LTDA;Prestação inadequada/insuficiente de informação;0;0;3;3;
2015;1º;04250224;MAGGI ADMINISTRADORA DE CONSORCIOS LTDA;Reclamações relacionadas a assuntos diversos;0;0;1;1;
2015;1º;17249375;MAPFRE ADMINISTRADORA DE CONSORCIOS S A;Ausência de transparência nas relações contratuais;0;0;3;3;
2015;1º;17249375;MAPFRE ADMINISTRADORA DE CONSORCIOS S A;Insatisfação com a resposta fornecida pela administradora de consórcio, a demanda registrada contra ela;2;1;0;3;
2015;1º;17249375;MAPFRE ADMINISTRADORA DE CONSORCIOS S A;Prestação inadequada/insuficiente de informação;0;0;2;2;
2015;1º;17249375;MAPFRE ADMINISTRADORA DE CONSORCIOS S A;Publicidade enganosa;0;0;5;5;
2015;1º;17249375;MAPFRE ADMINISTRADORA DE CONSORCIOS S A;Recusa ou demora no fornecimento de documentos (exceto demonstrativos obrigatórios);0;0;1;1;
2015;1º;45793395;MASSEY FERGUSON ADMINISTRADORA DE CONSORCIOS LTDA;Descumprimento de obrigações previstas em contratos;0;1;0;1;
2015;1º;45793395;MASSEY FERGUSON ADMINISTRADORA DE CONSORCIOS LTDA;Irregularidades relacionadas à liberação do crédito;0;1;0;1;
2015;1º;45793395;MASSEY FERGUSON ADMINISTRADORA DE CONSORCIOS LTDA;Reclamações relacionadas a assuntos diversos;0;0;1;1;
2015;1º;46349106;MERCABENCO MERCANTIL E ADMINISTRADORA DE BENS E CONSORCIOS LTDA;Descumprimento de obrigações previstas em contratos;0;1;0;1;
2015;1º;46349106;MERCABENCO MERCANTIL E ADMINISTRADORA DE BENS E CONSORCIOS LTDA;Outras irregularidades;1;0;0;1;
2015;1º;05126027;MOTOASA ADMINISTRADORA DE CONSORCIOS LTDA.;Descumprimento de cláusulas referentes à devolução de valores;0;1;0;1;
2015;1º;05126027;MOTOASA ADMINISTRADORA DE CONSORCIOS LTDA.;Irregularidades relacionadas às condições para contemplação por lance ou sorteio;0;1;0;1;
2015;1º;04124922;MULTIMARCAS ADMINISTRADORA DE CONSORCIOS LTDA;Descumprimento de cláusulas referentes à devolução de valores;0;4;0;4;
2015;1º;04124922;MULTIMARCAS ADMINISTRADORA DE CONSORCIOS LTDA;Insatisfação por parte do cliente com o atendimento prestado pela administradora de consórcio;0;0;2;2;
2015;1º;04124922;MULTIMARCAS ADMINISTRADORA DE CONSORCIOS LTDA;Não fornecimento, remessa ou divulgação de documentos obrigatórios;0;1;0;1;
2015;1º;04124922;MULTIMARCAS ADMINISTRADORA DE CONSORCIOS LTDA;Prestação inadequada/insuficiente de informação;0;0;2;2;
2015;1º;04124922;MULTIMARCAS ADMINISTRADORA DE CONSORCIOS LTDA;Publicidade enganosa;0;0;5;5;
2015;1º;04124922;MULTIMARCAS ADMINISTRADORA DE CONSORCIOS LTDA;Reclamações relacionadas a assuntos diversos;0;0;2;2;
2015;1º;05652765;NANUQUE ADMINISTRADORA DE CONSORCIOS LTDA;Cobrança irregular de tarifa pela emissão de boletos, carnês e assemelhados;0;1;0;1;
2015;1º;05652765;NANUQUE ADMINISTRADORA DE CONSORCIOS LTDA;Reclamações relacionadas a assuntos diversos;0;0;1;1;
2015;1º;33636838;NASA ADMINISTRADORA DE CONSORCIO LTDA;Insatisfação por parte do cliente com o atendimento prestado pela administradora de consórcio;0;0;1;1;
2015;1º;33636838;NASA ADMINISTRADORA DE CONSORCIO LTDA;Recusa ou demora no fornecimento de documentos (exceto demonstrativos obrigatórios);0;0;1;1;
2015;1º;50533876;PANAMERICANO ADMINISTRADORA DE CONSORCIO LTDA;Ausência de transparência nas relações contratuais;0;0;7;7;
2015;1º;50533876;PANAMERICANO ADMINISTRADORA DE CONSORCIO LTDA;Cobrança irregular de tarifa pela emissão de boletos, carnês e assemelhados;0;1;0;1;
2015;1º;50533876;PANAMERICANO ADMINISTRADORA DE CONSORCIO LTDA;Descumprimento de cláusulas referentes à devolução de valores;0;3;0;3;
2015;1º;50533876;PANAMERICANO ADMINISTRADORA DE CONSORCIO LTDA;Insatisfação com a resposta fornecida pela administradora de consórcio, a demanda registrada contra ela;0;1;0;1;
2015;1º;50533876;PANAMERICANO ADMINISTRADORA DE CONSORCIO LTDA;Insatisfação por parte do cliente com o atendimento prestado pela administradora de consórcio;0;0;7;7;
2015;1º;50533876;PANAMERICANO ADMINISTRADORA DE CONSORCIO LTDA;Irregularidades relacionadas à liberação do crédito;0;2;0;2;
2015;1º;50533876;PANAMERICANO ADMINISTRADORA DE CONSORCIO LTDA;Não fornecimento, remessa ou divulgação de documentos obrigatórios;0;1;0;1;
2015;1º;50533876;PANAMERICANO ADMINISTRADORA DE CONSORCIO LTDA;Prestação inadequada/insuficiente de informação;0;0;8;8;
2015;1º;50533876;PANAMERICANO ADMINISTRADORA DE CONSORCIO LTDA;Publicidade enganosa;0;0;1;1;
2015;1º;50533876;PANAMERICANO ADMINISTRADORA DE CONSORCIO LTDA;Reclamações relacionadas a assuntos diversos;0;0;5;5;
2015;1º;50533876;PANAMERICANO ADMINISTRADORA DE CONSORCIO LTDA;Recusa ou demora no fornecimento de documentos (exceto demonstrativos obrigatórios);0;0;2;2;
2015;1º;16551061;PONTA ADMINISTRADORA DE CONSORCIOS LTDA;Ausência de transparência nas relações contratuais;0;0;1;1;
2015;1º;16551061;PONTA ADMINISTRADORA DE CONSORCIOS LTDA;Insatisfação por parte do cliente com o atendimento prestado pela administradora de consórcio;0;0;2;2;
2015;1º;16551061;PONTA ADMINISTRADORA DE CONSORCIOS LTDA;Irregularidades relacionadas às condições para contemplação por lance ou sorteio;0;1;0;1;
2015;1º;16551061;PONTA ADMINISTRADORA DE CONSORCIOS LTDA;Reclamações relacionadas a assuntos diversos;0;0;2;2;
2015;1º;48041735;PORTO SEGURO ADMINISTRADORA DE CONSORCIOS LTDA;Ausência de transparência nas relações contratuais;0;0;12;12;
2015;1º;48041735;PORTO SEGURO ADMINISTRADORA DE CONSORCIOS LTDA;Descumprimento de cláusulas referentes à devolução de valores;0;4;0;4;
2015;1º;48041735;PORTO SEGURO ADMINISTRADORA DE CONSORCIOS LTDA;Descumprimento de obrigações previstas em contratos;0;2;0;2;
2015;1º;48041735;PORTO SEGURO ADMINISTRADORA DE CONSORCIOS LTDA;Descumprimento de prazo de resposta a demanda;0;1;0;1;
2015;1º;48041735;PORTO SEGURO ADMINISTRADORA DE CONSORCIOS LTDA;Insatisfação com a resposta fornecida pela administradora de consórcio, a demanda registrada contra ela;0;1;0;1;
2015;1º;48041735;PORTO SEGURO ADMINISTRADORA DE CONSORCIOS LTDA;Insatisfação por parte do cliente com o atendimento prestado pela administradora de consórcio;0;0;23;23;
2015;1º;48041735;PORTO SEGURO ADMINISTRADORA DE CONSORCIOS LTDA;Irregularidades relacionadas à liberação do crédito;0;5;0;5;
2015;1º;48041735;PORTO SEGURO ADMINISTRADORA DE CONSORCIOS LTDA;Irregularidades relacionadas às condições para contemplação por lance ou sorteio;0;1;0;1;
2015;1º;48041735;PORTO SEGURO ADMINISTRADORA DE CONSORCIOS LTDA;Outras irregularidades;0;1;0;1;
2015;1º;48041735;PORTO SEGURO ADMINISTRADORA DE CONSORCIOS LTDA;Prestação inadequada/insuficiente de informação;0;0;5;5;
2015;1º;48041735;PORTO SEGURO ADMINISTRADORA DE CONSORCIOS LTDA;Reclamações relacionadas a assuntos diversos;0;0;2;2;
2015;1º;48041735;PORTO SEGURO ADMINISTRADORA DE CONSORCIOS LTDA;Recusa ou demora no fornecimento de documentos (exceto demonstrativos obrigatórios);0;0;2;2;
2015;1º;87433413;PORTOBENS ADMINISTRADORA DE CONSORCIOS LTDA;Ausência de transparência nas relações contratuais;0;0;1;1;
2015;1º;87433413;PORTOBENS ADMINISTRADORA DE CONSORCIOS LTDA;Insatisfação por parte do cliente com o atendimento prestado pela administradora de consórcio;0;0;1;1;
2015;1º;87433413;PORTOBENS ADMINISTRADORA DE CONSORCIOS LTDA;Prestação inadequada/insuficiente de informação;0;0;1;1;
2015;1º;87433413;PORTOBENS ADMINISTRADORA DE CONSORCIOS LTDA;Reclamações relacionadas a assuntos diversos;0;0;1;1;
2015;1º;51597300;PRIMO ROSSI ADMINISTRADORA DE CONSORCIO LTDA;Descumprimento de cláusulas referentes à devolução de valores;0;5;0;5;
2015;1º;51597300;PRIMO ROSSI ADMINISTRADORA DE CONSORCIO LTDA;Descumprimento de obrigações previstas em contratos;0;8;0;8;
2015;1º;51597300;PRIMO ROSSI ADMINISTRADORA DE CONSORCIO LTDA;Descumprimento de prazo de resposta a demanda;0;1;0;1;
2015;1º;51597300;PRIMO ROSSI ADMINISTRADORA DE CONSORCIO LTDA;Prestação inadequada/insuficiente de informação;0;0;2;2;
2015;1º;51597300;PRIMO ROSSI ADMINISTRADORA DE CONSORCIO LTDA;Reclamações relacionadas a assuntos diversos;0;0;2;2;
2015;1º;51597300;PRIMO ROSSI ADMINISTRADORA DE CONSORCIO LTDA;Recusa ou demora no fornecimento de documentos (exceto demonstrativos obrigatórios);0;0;10;10;
2015;1º;91108027;RANDON ADMINISTRADORA DE CONSORCIOS LTDA;Ausência de transparência nas relações contratuais;0;0;1;1;
2015;1º;91108027;RANDON ADMINISTRADORA DE CONSORCIOS LTDA;Insatisfação por parte do cliente com o atendimento prestado pela administradora de consórcio;0;0;1;1;
2015;1º;91108027;RANDON ADMINISTRADORA DE CONSORCIOS LTDA;Irregularidades relacionadas à liberação do crédito;0;2;0;2;
2015;1º;66228966;REALIZA ADMINISTRADORA DE CONSORCIOS LTDA;Ausência de transparência nas relações contratuais;0;0;8;8;
2015;1º;66228966;REALIZA ADMINISTRADORA DE CONSORCIOS LTDA;Descumprimento de cláusulas referentes à devolução de valores;0;3;0;3;
2015;1º;66228966;REALIZA ADMINISTRADORA DE CONSORCIOS LTDA;Descumprimento de obrigações previstas em contratos;2;0;0;2;
2015;1º;66228966;REALIZA ADMINISTRADORA DE CONSORCIOS LTDA;Descumprimento de prazo de resposta a demanda;0;1;0;1;
2015;1º;66228966;REALIZA ADMINISTRADORA DE CONSORCIOS LTDA;Insatisfação com a resposta fornecida pela administradora de consórcio, a demanda registrada contra ela;0;2;0;2;
2015;1º;66228966;REALIZA ADMINISTRADORA DE CONSORCIOS LTDA;Insatisfação por parte do cliente com o atendimento prestado pela administradora de consórcio;0;0;3;3;
2015;1º;66228966;REALIZA ADMINISTRADORA DE CONSORCIOS LTDA;Irregularidades relacionadas à liberação do crédito;0;1;0;1;
2015;1º;66228966;REALIZA ADMINISTRADORA DE CONSORCIOS LTDA;Irregularidades relacionadas às condições para contemplação por lance ou sorteio;0;3;0;3;
2015;1º;66228966;REALIZA ADMINISTRADORA DE CONSORCIOS LTDA;Não fornecimento, remessa ou divulgação de documentos obrigatórios;1;1;0;2;
2015;1º;66228966;REALIZA ADMINISTRADORA DE CONSORCIOS LTDA;Prestação inadequada/insuficiente de informação;0;0;3;3;
2015;1º;66228966;REALIZA ADMINISTRADORA DE CONSORCIOS LTDA;Publicidade enganosa;0;0;26;26;
2015;1º;66228966;REALIZA ADMINISTRADORA DE CONSORCIOS LTDA;Reclamações relacionadas a assuntos diversos;0;0;2;2;
2015;1º;23767155;RECON ADMINISTRADORA DE CONSORCIOS LTDA;Ausência de transparência nas relações contratuais;0;0;1;1;
2015;1º;23767155;RECON ADMINISTRADORA DE CONSORCIOS LTDA;Descumprimento de cláusulas referentes à devolução de valores;0;3;0;3;
2015;1º;23767155;RECON ADMINISTRADORA DE CONSORCIOS LTDA;Insatisfação por parte do cliente com o atendimento prestado pela administradora de consórcio;0;0;2;2;
2015;1º;23767155;RECON ADMINISTRADORA DE CONSORCIOS LTDA;Irregularidades relacionadas à liberação do crédito;0;4;0;4;
2015;1º;23767155;RECON ADMINISTRADORA DE CONSORCIOS LTDA;Irregularidades relacionadas às condições para contemplação por lance ou sorteio;0;1;0;1;
2015;1º;23767155;RECON ADMINISTRADORA DE CONSORCIOS LTDA;Prestação inadequada/insuficiente de informação;0;0;3;3;
2015;1º;23767155;RECON ADMINISTRADORA DE CONSORCIOS LTDA;Publicidade enganosa;0;0;1;1;
2015;1º;23767155;RECON ADMINISTRADORA DE CONSORCIOS LTDA;Reclamações relacionadas a assuntos diversos;0;0;1;1;
2015;1º;23767155;RECON ADMINISTRADORA DE CONSORCIOS LTDA;Recusa ou demora no fornecimento de documentos (exceto demonstrativos obrigatórios);0;0;1;1;
2015;1º;62246228;REDENCAO ADMINISTRADORA DE CONSORCIO LTDA;Ausência de transparência nas relações contratuais;0;0;1;1;
2015;1º;62246228;REDENCAO ADMINISTRADORA DE CONSORCIO LTDA;Insatisfação por parte do cliente com o atendimento prestado pela administradora de consórcio;0;0;1;1;
2015;1º;62354055;REMAZA ADMINISTRADORA DE CONSORCIO LTDA;Ausência de transparência nas relações contratuais;0;0;2;2;
2015;1º;62354055;REMAZA ADMINISTRADORA DE CONSORCIO LTDA;Descumprimento de cláusulas referentes à devolução de valores;0;3;0;3;
2015;1º;62354055;REMAZA ADMINISTRADORA DE CONSORCIO LTDA;Descumprimento de prazo de resposta a demanda;0;1;0;1;
2015;1º;62354055;REMAZA ADMINISTRADORA DE CONSORCIO LTDA;Insatisfação com a resposta fornecida pela administradora de consórcio, a demanda registrada contra ela;0;2;0;2;
2015;1º;62354055;REMAZA ADMINISTRADORA DE CONSORCIO LTDA;Insatisfação por parte do cliente com o atendimento prestado pela administradora de consórcio;0;0;2;2;
2015;1º;62354055;REMAZA ADMINISTRADORA DE CONSORCIO LTDA;Irregularidades relacionadas à liberação do crédito;0;4;0;4;
2015;1º;62354055;REMAZA ADMINISTRADORA DE CONSORCIO LTDA;Prestação inadequada/insuficiente de informação;0;0;7;7;
2015;1º;62354055;REMAZA ADMINISTRADORA DE CONSORCIO LTDA;Publicidade enganosa;0;0;7;7;
2015;1º;62354055;REMAZA ADMINISTRADORA DE CONSORCIO LTDA;Reclamações relacionadas a assuntos diversos;0;0;12;12;
2015;1º;80402746;RIVEL ADMINISTRADORA DE CONSORCIOS LTDA;Recusa ou demora no fornecimento de documentos (exceto demonstrativos obrigatórios);0;0;1;1;
2015;1º;51855716;RODOBENS ADMINISTRADORA DE CONSORCIOS LTDA;Ausência de transparência nas relações contratuais;0;0;15;15;
2015;1º;51855716;RODOBENS ADMINISTRADORA DE CONSORCIOS LTDA;Descumprimento de cláusulas referentes à devolução de valores;1;5;0;6;
2015;1º;51855716;RODOBENS ADMINISTRADORA DE CONSORCIOS LTDA;Descumprimento de obrigações previstas em contratos;1;4;0;5;
2015;1º;51855716;RODOBENS ADMINISTRADORA DE CONSORCIOS LTDA;Descumprimento de prazo de resposta a demanda;0;1;0;1;
2015;1º;51855716;RODOBENS ADMINISTRADORA DE CONSORCIOS LTDA;Insatisfação com a resposta fornecida pela administradora de consórcio, a demanda registrada contra ela;0;6;0;6;
2015;1º;51855716;RODOBENS ADMINISTRADORA DE CONSORCIOS LTDA;Insatisfação por parte do cliente com o atendimento prestado pela administradora de consórcio;0;0;26;26;
2015;1º;51855716;RODOBENS ADMINISTRADORA DE CONSORCIOS LTDA;Irregularidades relacionadas à liberação do crédito;0;12;0;12;
2015;1º;51855716;RODOBENS ADMINISTRADORA DE CONSORCIOS LTDA;Irregularidades relacionadas às condições para contemplação por lance ou sorteio;0;4;0;4;
2015;1º;51855716;RODOBENS ADMINISTRADORA DE CONSORCIOS LTDA;Não fornecimento, remessa ou divulgação de documentos obrigatórios;0;1;0;1;
2015;1º;51855716;RODOBENS ADMINISTRADORA DE CONSORCIOS LTDA;Outras irregularidades relacionadas à Ouvidoria;0;1;0;1;
2015;1º;51855716;RODOBENS ADMINISTRADORA DE CONSORCIOS LTDA;Prestação inadequada/insuficiente de informação;0;0;7;7;
2015;1º;51855716;RODOBENS ADMINISTRADORA DE CONSORCIOS LTDA;Publicidade enganosa;0;0;1;1;
2015;1º;51855716;RODOBENS ADMINISTRADORA DE CONSORCIOS LTDA;Reclamações relacionadas a assuntos diversos;0;0;11;11;
2015;1º;51855716;RODOBENS ADMINISTRADORA DE CONSORCIOS LTDA;Recusa ou demora no fornecimento de documentos (exceto demonstrativos obrigatórios);0;0;4;4;
2015;1º;80674393;SANTA FE ADMINISTRADORA DE CONSORCIOS LTDA;Descumprimento de cláusulas referentes à devolução de valores;0;1;0;1;
2015;1º;55942312;SANTANDER BRASIL ADMINISTRADORA DE CONSORCIO LTDA;Ausência de transparência nas relações contratuais;0;0;1;1;
2015;1º;55942312;SANTANDER BRASIL ADMINISTRADORA DE CONSORCIO LTDA;Descumprimento de cláusulas referentes à devolução de valores;0;2;0;2;
2015;1º;55942312;SANTANDER BRASIL ADMINISTRADORA DE CONSORCIO LTDA;Descumprimento de obrigações previstas em contratos;1;3;0;4;
2015;1º;55942312;SANTANDER BRASIL ADMINISTRADORA DE CONSORCIO LTDA;Insatisfação com a resposta fornecida pela administradora de consórcio, a demanda registrada contra ela;0;1;0;1;
2015;1º;55942312;SANTANDER BRASIL ADMINISTRADORA DE CONSORCIO LTDA;Insatisfação por parte do cliente com o atendimento prestado pela administradora de consórcio;0;0;8;8;
2015;1º;55942312;SANTANDER BRASIL ADMINISTRADORA DE CONSORCIO LTDA;Irregularidades relacionadas à liberação do crédito;0;2;0;2;
2015;1º;55942312;SANTANDER BRASIL ADMINISTRADORA DE CONSORCIO LTDA;Prestação inadequada/insuficiente de informação;0;0;3;3;
2015;1º;55942312;SANTANDER BRASIL ADMINISTRADORA DE CONSORCIO LTDA;Reclamações relacionadas a assuntos diversos;0;0;3;3;
2015;1º;55942312;SANTANDER BRASIL ADMINISTRADORA DE CONSORCIO LTDA;Recusa ou demora no fornecimento de documentos (exceto demonstrativos obrigatórios);0;0;1;1;
2015;1º;96479258;SCANIA ADMINISTRADORA DE CONSORCIOS LTDA;Irregularidades relacionadas à liberação do crédito;0;2;0;2;
2015;1º;96479258;SCANIA ADMINISTRADORA DE CONSORCIOS LTDA;Reclamações relacionadas a assuntos diversos;0;0;1;1;
2015;1º;76515071;SERVOPA ADMINISTRADORA DE CONSORCIOS LTDA;Ausência de transparência nas relações contratuais;0;0;1;1;
2015;1º;76515071;SERVOPA ADMINISTRADORA DE CONSORCIOS LTDA;Descumprimento de cláusulas referentes à devolução de valores;0;1;0;1;
2015;1º;76515071;SERVOPA ADMINISTRADORA DE CONSORCIOS LTDA;Descumprimento de prazo de resposta a demanda;1;0;0;1;
2015;1º;76515071;SERVOPA ADMINISTRADORA DE CONSORCIOS LTDA;Prestação inadequada/insuficiente de informação;0;0;1;1;
2015;1º;87945218;SIMPALA LANCADORA E ADMINISTRADORA DE CONSORCIOS LTDA;Descumprimento de obrigações previstas em contratos;0;1;0;1;
2015;1º;87852273;SINOSSERRA ADMINISTRADORA DE CONSORCIOS S A;Ausência de transparência nas relações contratuais;0;0;2;2;
2015;1º;87852273;SINOSSERRA ADMINISTRADORA DE CONSORCIOS S A;Descumprimento de cláusulas referentes à devolução de valores;0;2;0;2;
2015;1º;87852273;SINOSSERRA ADMINISTRADORA DE CONSORCIOS S A;Irregularidades relacionadas às condições para contemplação por lance ou sorteio;0;1;0;1;
2015;1º;87852273;SINOSSERRA ADMINISTRADORA DE CONSORCIOS S A;Prestação inadequada/insuficiente de informação;0;0;1;1;
2015;1º;54708839;SPERTA ADMINISTRADORA DE CONSORCIO NACIONAL LTDA;Ausência de transparência nas relações contratuais;0;0;1;1;
2015;1º;54708839;SPERTA ADMINISTRADORA DE CONSORCIO NACIONAL LTDA;Irregularidades relacionadas à liberação do crédito;0;1;0;1;
2015;1º;87636635;SPONCHIADO ADMINISTRADORA DE CONSORCIOS LTDA;Prestação inadequada/insuficiente de informação;0;0;2;2;
2015;1º;57723801;SUZUKI MOTOS ADMINISTRADORA DE CONSORCIO LTDA;Ausência de transparência nas relações contratuais;0;0;1;1;
2015;1º;57723801;SUZUKI MOTOS ADMINISTRADORA DE CONSORCIO LTDA;Descumprimento de cláusulas referentes à devolução de valores;0;1;0;1;
2015;1º;57723801;SUZUKI MOTOS ADMINISTRADORA DE CONSORCIO LTDA;Irregularidades relacionadas à liberação do crédito;0;3;0;3;
2015;1º;57723801;SUZUKI MOTOS ADMINISTRADORA DE CONSORCIO LTDA;Irregularidades relacionadas às condições para contemplação por lance ou sorteio;0;1;0;1;
2015;1º;57723801;SUZUKI MOTOS ADMINISTRADORA DE CONSORCIO LTDA;Prestação inadequada/insuficiente de informação;0;0;1;1;
2015;1º;57723801;SUZUKI MOTOS ADMINISTRADORA DE CONSORCIO LTDA;Reclamações relacionadas a assuntos diversos;0;0;4;4;
2015;1º;53211488;TARRAF ADMINISTRADORA DE CONSORCIOS LTDA;Insatisfação com a resposta fornecida pela administradora de consórcio, a demanda registrada contra ela;0;2;0;2;
2015;1º;53211488;TARRAF ADMINISTRADORA DE CONSORCIOS LTDA;Irregularidades relacionadas à liberação do crédito;0;2;0;2;
2015;1º;53211488;TARRAF ADMINISTRADORA DE CONSORCIOS LTDA;Irregularidades relacionadas às condições para contemplação por lance ou sorteio;0;1;0;1;
2015;1º;53211488;TARRAF ADMINISTRADORA DE CONSORCIOS LTDA;Prestação inadequada/insuficiente de informação;0;0;1;1;
2015;1º;59956185;TRADICAO ADMINISTRADORA DE CONSORCIO LTDA;Ausência de transparência nas relações contratuais;0;0;4;4;
2015;1º;59956185;TRADICAO ADMINISTRADORA DE CONSORCIO LTDA;Descumprimento de obrigações previstas em contratos;0;1;0;1;
2015;1º;59956185;TRADICAO ADMINISTRADORA DE CONSORCIO LTDA;Insatisfação com a resposta fornecida pela administradora de consórcio, a demanda registrada contra ela;0;1;0;1;
2015;1º;59956185;TRADICAO ADMINISTRADORA DE CONSORCIO LTDA;Insatisfação por parte do cliente com o atendimento prestado pela administradora de consórcio;0;0;1;1;
2015;1º;59956185;TRADICAO ADMINISTRADORA DE CONSORCIO LTDA;Irregularidades relacionadas à liberação do crédito;0;3;0;3;
2015;1º;59956185;TRADICAO ADMINISTRADORA DE CONSORCIO LTDA;Prestação inadequada/insuficiente de informação;0;0;3;3;
2015;1º;59956185;TRADICAO ADMINISTRADORA DE CONSORCIO LTDA;Publicidade enganosa;0;0;1;1;
2015;1º;59956185;TRADICAO ADMINISTRADORA DE CONSORCIO LTDA;Reclamações relacionadas a assuntos diversos;0;0;1;1;
2015;1º;83553883;UNIAO CATARINENSE ADMINISTRADORA DE CONSORCIOS LTDA;Descumprimento de cláusulas referentes à devolução de valores;0;1;0;1;
2015;1º;83553883;UNIAO CATARINENSE ADMINISTRADORA DE CONSORCIOS LTDA;Prestação inadequada/insuficiente de informação;0;0;1;1;
2015;1º;60732997;UNIFISA ADMINISTRADORA NACIONAL DE CONSORCIOS LTDA;Ausência de transparência nas relações contratuais;0;0;1;1;
2015;1º;60732997;UNIFISA ADMINISTRADORA NACIONAL DE CONSORCIOS LTDA;Descumprimento de cláusulas referentes à devolução de valores;0;4;0;4;
2015;1º;60732997;UNIFISA ADMINISTRADORA NACIONAL DE CONSORCIOS LTDA;Descumprimento de obrigações previstas em contratos;0;1;0;1;
2015;1º;60732997;UNIFISA ADMINISTRADORA NACIONAL DE CONSORCIOS LTDA;Insatisfação com a resposta fornecida pela administradora de consórcio, a demanda registrada contra ela;0;1;0;1;
2015;1º;60732997;UNIFISA ADMINISTRADORA NACIONAL DE CONSORCIOS LTDA;Prestação inadequada/insuficiente de informação;0;0;3;3;
2015;1º;60732997;UNIFISA ADMINISTRADORA NACIONAL DE CONSORCIOS LTDA;Publicidade enganosa;0;0;2;2;
2015;1º;81269516;UNILANCE ADMINISTRADORA DE CONSORCIOS LTDA;Insatisfação por parte do cliente com o atendimento prestado pela administradora de consórcio;0;0;2;2;
2015;1º;81269516;UNILANCE ADMINISTRADORA DE CONSORCIOS LTDA;Irregularidades relacionadas à liberação do crédito;0;1;0;1;
2015;1º;81269516;UNILANCE ADMINISTRADORA DE CONSORCIOS LTDA;Prestação inadequada/insuficiente de informação;0;0;6;6;
2015;1º;81269516;UNILANCE ADMINISTRADORA DE CONSORCIOS LTDA;Publicidade enganosa;0;0;3;3;
2015;1º;81269516;UNILANCE ADMINISTRADORA DE CONSORCIOS LTDA;Reclamações relacionadas a assuntos diversos;0;0;1;1;
2015;1º;81269516;UNILANCE ADMINISTRADORA DE CONSORCIOS LTDA;Recusa ou demora no fornecimento de documentos (exceto demonstrativos obrigatórios);0;0;1;1;
2015;1º;45594223;VEMAR ADMINISTRADORA DE CONSORCIO LTDA;Irregularidades relacionadas à liberação do crédito;0;1;0;1;
2015;1º;77038990;VOUPAR ADMINISTRADORA DE CONSORCIOS LTDA;Descumprimento de cláusulas referentes à devolução de valores;0;1;0;1;
2015;1º;47458153;YAMAHA ADMINISTRADORA DE CONSORCIO LTDA;Ausência de transparência nas relações contratuais;0;0;4;4;
2015;1º;47458153;YAMAHA ADMINISTRADORA DE CONSORCIO LTDA;Cobrança irregular de tarifa pela emissão de boletos, carnês e assemelhados;0;1;0;1;
2015;1º;47458153;YAMAHA ADMINISTRADORA DE CONSORCIO LTDA;Descumprimento de cláusulas referentes à devolução de valores;0;3;0;3;
2015;1º;47458153;YAMAHA ADMINISTRADORA DE CONSORCIO LTDA;Descumprimento de obrigações previstas em contratos;0;2;0;2;
2015;1º;47458153;YAMAHA ADMINISTRADORA DE CONSORCIO LTDA;Insatisfação com a resposta fornecida pela administradora de consórcio, a demanda registrada contra ela;0;1;0;1;
2015;1º;47458153;YAMAHA ADMINISTRADORA DE CONSORCIO LTDA;Insatisfação por parte do cliente com o atendimento prestado pela administradora de consórcio;0;0;4;4;
2015;1º;47458153;YAMAHA ADMINISTRADORA DE CONSORCIO LTDA;Irregularidades relacionadas à liberação do crédito;3;4;0;7;
2015;1º;47458153;YAMAHA ADMINISTRADORA DE CONSORCIO LTDA;Irregularidades relacionadas às condições para contemplação por lance ou sorteio;0;1;0;1;
2015;1º;47458153;YAMAHA ADMINISTRADORA DE CONSORCIO LTDA;Prestação inadequada/insuficiente de informação;0;0;3;3;
2015;1º;47458153;YAMAHA ADMINISTRADORA DE CONSORCIO LTDA;Reclamações relacionadas a assuntos diversos;0;0;2;2;
2015;1º;23367634;ZEMA ADMINISTRADORA DE CONSORCIO LTDA;Ausência de transparência nas relações contratuais;0;0;1;1;
2015;1º;23367634;ZEMA ADMINISTRADORA DE CONSORCIO LTDA;Descumprimento de cláusulas referentes à devolução de valores;0;1;0;1;
2015;1º;23367634;ZEMA ADMINISTRADORA DE CONSORCIO LTDA;Descumprimento de prazo de resposta a demanda;0;1;0;1;
2015;1º;23367634;ZEMA ADMINISTRADORA DE CONSORCIO LTDA;Insatisfação por parte do cliente com o atendimento prestado pela administradora de consórcio;0;0;1;1;
2015;1º;23367634;ZEMA ADMINISTRADORA DE CONSORCIO LTDA;Publicidade enganosa;0;0;4;4;
2015;1º;23367634;ZEMA ADMINISTRADORA DE CONSORCIO LTDA;Recusa ou demora no fornecimento de documentos (exceto demonstrativos obrigatórios);0;0;5;5;
